00T000000000000000000000000000
000S0G0G0000000000T0S0C0000000
00G00S00000GT0H0000000S0000000
0G00GT000000S000000H0000000000
0000T0000SS000000000000G0000C0
000000G00000000000000000000000
0000000000000000000GT0S0000000
0G000000G00T00S000000000000000
00000000T000000000000000000000
0S00000000G000S000000000000000
0000000000T00G0000000000000000
000T0000S00000000000000000000G
00000T00S00S0000000000000GG000
00G0000000GH00000S0T00000S0000
0000T00000S000000G00000S000000
00G00000T00000G000000000000000
0000000T00000000G000000000S000
0000SG0000T00000G0HH0000000S00
0S000GT0000000000000000GH00000
00000000000000000000S000S00000
0000000000000000000SG00T000000
00000000000T0000S00S000000000G
000000S00000G0000G00T000000000
0S000000S0000C00000000G0G00000
0T000000S000000SG00000000G0000
0000000000T000000S0000GS000000
000000000S000000000000000S0000
00000T000000000000000000000000
000000T00000000000G00000G00000
0000S00G00T000000000000G000000
