000000t00S000000000g00000000S0
000S00000000000000t000000g00SM
0tSg000000S0000000000000000000
00000000000000t00000g000000g00
000000000g0S000000Stg000000000
0000t0000000000000000000000000
t00g00S000000000g000000000000B
00000tS0000gS000000000000000g0
0000000g0000g00000000000000000
t00000000S00000000000000000000
00000000000000S000000000000000
0g0000000000SSM0000000000000M0
S00000000000000000S000000g0000
00S0000000000S0t00000000000000
000g0000000S0000000000SM00tM00
0000000t0000S00000000000000000
0000000t00000000000000S00000g0
000St0g000S00000000g0000000000
00000000000000000000000000S000
0000000000000000000g00000S0S00
000000S000000gg000000000000t00
gg0B000000000S0000000000000000
00000000g000S00t00000000000000
t00000000000000000000000000000
0t000000000000S0000g000g00B000
0000000S000t0S0000000g0000g000
tg000000000000000000gB00000000
0000S000000000000000000000S0t0
0gt000000g0S00000000000000S000
000000S0gg00000000000000B0000t
