00000000000000ST00000000000000
000000G0000000000000000S0T0000
0000000S000G00T000000000000000
00S00000000T00000000GS00000000
0000000S0000000000S0GG00H000H0
S00G0S000000000000000000000000
000S0000000000T00G00G0000H0000
000G0000G000000000S00000H00000
0T0000000G00000000000000000000
0G00S0S00000000TG000000H0H0000
000SS000TC00000000000000000000
00G00G0000000S000000000000T000
0000G0S0G00000000S00000C000000
00000000TS0G00000000000000S00G
000T00000G00S00S000000000000C0
0000000G000000T000000000000000
0000000T00S000000000000SC00000
0000S0000000S00000G00000000000
0000T000000000S00000S00000000G
000000000000000G0TGHH000000000
S0000000000T000000000G00000000
G000000T000S00000000000000S0C0
00000T0000SG0000000000000S0000
S0G000000T0S0000G0000000000000
00T0000S00S0C00000000000000000
000T000000000GS000000000000000
000000000000000000000S0000S000
000ST000000000000000000S000000
T0000000000000000G0G0000H00000
000000S0000TS0000GGH0H00000000
