0000000000000000000t0000000000
g0t000000000000000gSSM0000000B
0000000000S0000t00000g00000000
0S000000t0000000000g0000000000
0S0000000S00000000000000t00000
00000S00000000000000000000000S
00g000000000000000S00000000t00
00000000t0000000S0000000000000
0000000gt000000000000000000000
00000000t0S00000000000000g0000
000000000000S0g00t00000g000000
g00t00S000000000g00000B00000S0
00S000000000000S00g000000000t0
0000t0000000000000000SS000g000
00S000t000000Sg000000000000000
SS0000t000g0000000g0000B000000
000000000000000000000000000000
S00000000tg0000000000g00000000
000g0t000000g0000000000000000B
0000000000t0S000g0000000000000
00S00000000t00g000S00000000000
000000t0g0g00000000000000S0000
00000t00S00000000S000000000000
St00000S0000000000000000000M0M
0000000000000000000St00000000S
000000000g0000000t000g00000000
0tS0000S0000M000000M00M0000000
00t000S00000g00000000000000000
0S000000000000000t000000000000
t0000S00000000000000gS00g00000
