S00G00000000S000T0000G0C00C000
0000GG00S000T00000000000000000
0000G00S0000T000G0000000000000
00000000000T000000000000000000
0S00000000S0T00000000GG0000000
0SS00G00000C000000000000000000
0000000000000000000G0000T00000
0000000000000G00000000ST000S00
000000S00000G00TS00000000000C0
00000000000G000G000S00000S0000
0000000000S000000000000000S0G0
0000T0000000000000G000000S0000
0000ST000000000000000000000G00
00STG00S00000000000000G0C00000
000G000000000000SS0000T0000000
000000T0000S000000S00000000000
00000000000000G0T0000000000000
00T0000000000G0000000000000000
00000000000S0000000000000000SC
000S00G0S000000000000000000C00
0S0000000000000000G00000000000
000G000000000TG000000000000000
T000000000000000000000000000S0
G0T00000000000000000G000000000
00000000T000000000000000G00000
0T000000000S00000G000000000000
00000G00000000S00000T000000000
000000000G00000000000T0000G000
00000G00000000000G00H0T0S00000
000000000000000G0000G00H000000
