000g000000g000SS00000MM000M000
00g000000t00000000000000000000
000000g00000t0000000S000000000
0S000000000t000000000000000000
0000000g000t000000000000000000
0000S0g00000000Stg000000000000
S00000000000g00000S0gt00000000
00000000000t00000000000g000000
0t0000000000000000000000000S0g
000g0000000000000000g00000S000
gS00000g000B000000000000000000
000g00000000S000t0Sg0000000B00
000000000000g00000000St0000000
00000t0000000000000000000000gS
S00000000000000000000g0000000g
000g00000000000tg0B00000000000
S000000000000t0000000S000g0000
000000g0gt00000S0000000000S000
0000g0000000000t00S00000S00000
000S000000t000000S000000000000
000000000000tS0g0000000000000S
0g00000000000000S000000g00000B
0g00000000SS0M0t00000000000000
0000000000000000g000t000000000
00t00000000000g0S000000000000g
000g0S0t0000000000000000S00000
00S00t00000000000000SM00000000
0000t0000000000000SS00M000000g
000000000000000000000000000000
000000t000000g0000000000000000
