00000Sg000S0000000000000000000
00g00g00000B0000t0000000S00000
00000000000000t000000000000000
00000000t000000000000000000000
00000g0g0000000B0B00t0000S0000
00gg000000B0000000000000B00000
0g00000S0000g000000000t00B0B00
00000000000000000S00000S0g000M
tS0000000000g0000gS000BB000000
00000000000S0000t0000000000000
00g0S0000000g00000000000000000
000000000000000000000000000t00
000t00000000000000g0000000000S
000000000000000000t000000000S0
00000000000000000000000000S00S
00S00S000000000g00000000000000
00gt000000000000000000g0B0000B
0g00000000000000000S00000000t0
00000000t00g0000000SS0M0000000
00000g000tS0g00000000000000000
00t0g00S0S0M0M0M0000g00000000M
S00S00000t0000000000000g0000g0
0S000000t0000g00000000000000SM
0S0g00000000g0000000000000000B
000t0000000g000g0000000S000000
0000000000S0000t0000g0000S0000
000g0000000000g0000S0B00000000
00gg00B000000000S0000B0000Bt00
000000000000gg0B0000000B000000
00t0000S00000S000M000000g00000
