0000S000000T0000000S00G0000000
G00000TG000000000000H000000000
000000000000000000000000S0000G
0000T0000000000G000G000S000000
0000T000000G000000SS0000000000
0000000GG000000000000000HS0000
0000000000000S000000SG0000C000
00000S0000GS00000CG0H00000CC00
00000000000000T00S000000000G00
000G000000T0000000G00000000000
00000G000000000000000000G0T0H0
000T000000000000G0000000000000
000T0000000000000000G0S0000000
00000T0000000000000G000000000S
0G0T0G000000000000000000000000
000000G0000000000000000T0G0000
000000000000000T0000000000S00G
0S00000000G000000000G0000000ST
000000000000000000000000000000
000T00S000000000S0000000000000
ST00S00000000000C00000000GC000
0000S0000000000000G00G0000S000
000T00000000000G00000000000000
S00GT000000000000000000G000000
000000000000000000S00000000000
0000S0000000T0S000000000000000
0T0000000000000G0S000S00000000
000000T0G000000G0HSH0S00000000
0000000S0000000T00G00G00000000
00000GG0000000H0000000S000S000
