0000t00000000g0000g000000B0S00
000000000g000000000000g0000000
0000000S0t00000000000000000000
S00000000t0000S000g00000M00g00
00000g000gt0S0B00000000000S00B
0000000000000000000000000t0000
000g0000000000g00t000000000000
000S00000000tg00000S000g000000
00S0000gS000M000M000000000000g
0t0g00000000000000000S00000000
000t00000000S00000S00000000g00
000Sgt00000000000000000g000000
0000000000t00000000S0000g00S00
00t0g000000000000g00000000S000
0S0S00t00000000000000000000000
t0000000000000000S000000S0g000
000000000000S000S0000000000t00
000000St00g0000000000000000000
000S00S00000g0Mg0000M000000000
0g0S0000t000000000000000000000
000000000g00000t000000000S0S00
00g0000t000000000000000000S00S
000000000000000000t000000g0000
0t00000000000000S000g000000000
000000g00000SS00t0000000M0g000
00S000gSg0000Bt0000B0000000000
000000000000S000g0S00gB00t0000
0000t0g000g0S0000000S000000000
00000000t0000000000000000000g0
00t000g000000g0000000000S00000
