000000000000000000000t00000000
000000000000000000S0g000000g00
000000g000000S00gSB0000t0M0000
0000000000t000000g000000000000
00t00000000000S0000g0000S00000
00SS0000000000000t0000000M0000
000000g0g0S00B00000000000000B0
0000t0000g00000000000000000000
0000000000000000000000000000g0
000g0000000000t000000Sg00000S0
00000000S000000000000000000gS0
00S0000000g00S0t00000000000000
00000000000g0000000g00B0000t00
00000Sg00t000S000000MM000000g0
t000000000000000000000g0000g00
0000000t000000000000S000000000
0S00000000000S00M00000000g0000
0St000000000S00000000000000M00
000g00000000000000000S00000000
S00gS0000000000000g00000000000
0000000g0000000t0000000000000g
0000t00g0000000000g0S000000000
0000t00000000000000000000000S0
0000g000000000000000g0000000B0
0t000000g000S0S00M0M00000000M0
00SSt0000000000000000000000000
000g000S00000000gB0t000000S000
0g00S0000g000000000000000t00B0
0000St000S000M0000000000000000
00000t000S00000000000000000000
