0000G0S0000T000000000000S00000
0S00000S000000000000000000C00T
000000000T000000000000S0000000
0000000000000G0S00000000000S00
0S0000G000000G000H000000000000
0000G000000000S000T0000000S000
0000000TS00000G00000G000000000
T0000G000000G000000000H0S000H0
0000T00000S00000000G0000000000
0000T00G00000000000000S0000000
0000000000000T0000000000000000
0000000000S0000000000000000000
0000G0000G000000T0000H00000000
00000000S0000000T000000000S000
00000000G000000T0S000000000000
00000G000S000T000000000000G000
T0G00000000000000S0G0000S00C0C
000T000000S00000G000000G000000
00000T0000S00000S00000G0C00000
0000000G00000000G00000000000T0
0000T00000000000S0000000000000
000000S00000G00000000000000000
00000000G00000000T0000000S00G0
000000000G000000000000000000T0
00000G000000000000S0000T000000
0000000000000T00000S00000000S0
000G0000000000000000000S00GH00
00000000000G0000S0000000T00000
00000T0G00S0000000000000000000
G00000000G00000000T00000S00000
