TG0000G00000000000H00000000H00
00000000000G00000S000000000000
000000000T0S000000000G000000G0
000000GG00S00000000000000000S0
000000G00000000T0G000000000000
0000000000S000000000000S00000T
000000000000T00S00000000000000
000000S0000000000000G00000000S
000000000000G0000T00000000000G
000T000G000000000G000000000000
00000000T000S00000S0000000C000
00000000T000S00000000000S00C00
0000000T0000000000SG0000000000
0000S000000000000000000G00T000
0G0000000000000000G0000T000000
000S00T0000000000000000000G000
00000T00000000000G000000000000
000000000000000000000G00T00000
000T0000G000S0S000C0000000G000
00T00G00000000000S000000000000
T0000000000000000000GS0000G000
SS00000000GT000000000GH000C000
0S00000G000000G0000S0000000000
00000000000000T00000000000S000
000000000000000000000T00000000
000G0000000T000000000000000000
000000000000000S00000000G0000S
000000000T00000GG000000S000S0H
0000000TS0000000S0C0000G0C0000
00000000G00000000T0S000S000000
