00000000G0T00000000G00H0000000
00000T0G0G000000000000000H00S0
0T000000000000000000S000000S00
0000000000T0000000000000S00000
00000000GT0000000000000000000S
000000000000000000G0000000T000
0000000000000G00000G0000S00000
0000T00S0G000000000S000000000G
0000T00000000000S0S00000000000
000000T0000000S000000000000S00
00000000000T00G0000000G0H00000
000000T00000000000000000000000
000000S0000G000000000000000T00
000000G0000000000000S000S00000
0000000S00000000000000S000G000
G00000000000000000000T00000000
00TS000000000000000000G0000000
0000000S000000G00000S000000000
0S00000000G0000000000000T000G0
000000000S000000000000000S0000
SG0000000000000000000000000000
T000S0S00000000000CG0000000000
000000000000000000000000000000
00000000000T000G00G0H000000H00
000000000000T000000000S000000G
00000G000000000S00000000GT0S00
0TGS00000000000S00G0000000H000
0T0000000000000000000000000000
G000000000000000SS0C00000000T0
0SG0000000000000S000G00H0000C0
