000S0000000000S000000M00000tg0
0t0g00000000000000000000000000
00S00000S000000000M0000t0000g0
000tg00000000000000000000g0000
000g0t0000000000S000S0000g0000
00t000000000g00000S00000000000
00000000S000S0t000000000000000
0000000S000g000000S00MM0000000
g00000000S000000000g00tB00000B
00t0000000000g0000000000gB0000
000t00000000S000S0000M00000000
0000g0000000000000000000000g0B
0t00000000000g000000SgB00000B0
0000000000000000g00000000S0t00
g0000g000St0000000000000000B00
00000t0000000000g0000000000000
0000000000gg000000000t00000000
00000S00000S0000000000000t0000
0000S000000g000S0000g000000000
000gg0B0B000000S0000000000t000
000000g00000000g000B0000000000
00000000t00000000000000000000S
0000000t0000000000000000000000
0S0t000000gg000000000000000000
00000000000t00000000000S000000
00000000000000g00000000g000000
00000000000000000000g000000000
000gS00000g0B0000000S00t000000
0SS0g0000gB0000000000000000M00
0000000000000S00000g0000000000
