000S0000g0S0000000g00M000MM000
0000000S0t000g0000000000000000
0000000000g0000gB000t0S0000000
00000S0000g0000000S000M00000g0
0S0000Stg0000000M00M000M000000
000000000t000g00000Sg000000000
00000000000000S000S00000000tg0
000tS0000000000000000000000000
0000000000g000000g000000000000
000000t00000000000000000000000
0000S00000gS00t00M000000000000
00000000S0000000000S00000t0000
0000t000Sg0000000g000000000000
00000000000000000000000000000t
00S000t000000S0M000000000000M0
000000000000S0000S00M000M0000g
00000000t00S0000000gg000000000
0000000000t000000@0S0000000000
g0000000S0000S000000000000M000
0000t000000S000000000000000000
00S0000000g000000000t0000S0000
000000000000000000000000000000
S0000S00000000000t000000000000
000000g0000000000t000g00000SB0
S000g00000S00M0000t00000000000
0g00000000000000S00000S00000M0
0000g00000S0000000000000000000
S0t000000000000000000000000000
S0gt0g0000000S0B0BM00000B00000
0t00000000000Sgg0000B0B0000000
