00000000000000000000000g00000g
0000g000g000000000000000000000
0000000g00t0000000000000S00000
00tS0S0000000M0g00000000000000
0000000g0000000g00t00000000000
g000g00000000B00000000000000S0
00000000000000000000t000000000
00000000000gt00000000000000000
0S0000000000g00000000000000000
00000S000000000000000t00000000
00000St0000000000000000000g000
0t000000000000S00000000S000000
00g00g0t0000000000000000000000
0S0S0000000000000t00000g000000
0000gt0g000S0B0000000000000S00
000000g00t00000000g0S0B00B0000
00000S0000000000000SM00t000000
0t000000000000000000000Sg00000
000000g00t000000000S000000g0S0
0000t000000000g000000g00000000
00S00000t00000S0g00g0000000000
00000g000000000000000000000000
000000S00000000000S00000000t00
S000S000000000g000000000000000
00000000000000S000000000000000
000000t000000000000S0000000000
00000000000000t00000000000S000
0000000000t000000000000g00000g
0000S0000000g00000S0M0t0000000
0g000000000000000000000g000000
