S00g0000g00000000000000000000B
00t0000000S000000000000S0000g0
Sg00g0000000000t00000000B0000S
00000000000000SS0t000000000000
00g00g000B000t000S000000S00000
00000000t00000S0000S0000000000
00000000g0g0000000000BS0B000B0
0t00000000000000000gg000000000
00000t000000S00000000000000000
00000t00S000000000000g00000000
g0000000000S00t00g00000000S000
00g0t0S0000000000000S00M000000
0000000000000000000S00t0000000
g00000000000000g00000S0S000000
00g00000000000000St0000g00000B
000g0000t00g0000000000000B0000
0t00000000000000g0000S00000000
00t000000000000000000000000000
0000g0000000g00000B00000St0000
0t000000S000000000SM0000000000
00000000000000000000000g000t00
000000S000g000000000g0000t0000
00000g000000000000000000000000
0000S000t00Sg000000M0000000000
00000000t00000S0000000000000g0
00000t0000000000000S0000000000
00t0000000S00000000000000S0g00
0t0000000000000000000000000000
0000000000S0g000000000000g00B0
00000000S00000g000t0000g000000
