000000S00000000S0M00M000000000
000000000000000S0g00000t000000
0000000000000000gg00000SS000MM
00S00000t000000000000000000000
S00000t00000000000000000000000
0000S000g0000000S000000000000g
00000S0000S000000000000000M00g
g0000000000000000t00g0000000S0
00000000g000000000000000S00000
0000g00g0000tB0000000S00000000
0000000t0000000S00000000S00000
0000t00000000000g0000000000000
000000000S000000000Sg0g00B0000
000t0000000000g00000000S000000
00S000t000g00S00000000000M00M0
S0gS0M00000g0000M0000000B0B000
000tS00000000g0000S00000000000
000000g0S000000000000000000000
0000000000000000000000g000t000
S00000000000S00t00000000M00000
g000t00g0000000000000S00000000
000000000000000S00t00000000000
S00S0M0000000000000000t00000M0
000000S00SM00t0000000M0000g0M0
tS00000000000000S00000M0000000
00t0000000000S000000S00000g000
0000Sgt0g0B0000000000B0S000000
0000000tgg00B00000S0S0000M0000
000000000000g00S0S00000000000t
0000S0S0t00g000000000M0g0B0000
