0T00000G00S0000000S0000G000C00
00T000G0000000000000000000G000
G0000000S00000000000S0T0000000
00000000000G0S00S0000000T000G0
0000000000000000S00G0000000000
0000000G000000S0G000S00T000000
0000000G000000000000S000T00000
0000G00000T000000000G000000000
0000S00G000000000000000000S000
00000000000000T00000G000S00000
00S00000S0000C00000T00C0000000
00000000000000000000G000000000
000000T00000G00000000000000000
0000000000ST00GG00000000000000
00G000000000000000T00G00000000
00000000SS00000T0000C000000000
S0000000000000S000000000000000
000000000000000000T00000000000
000G0S0000S00000000C000CT00G00
0T000000000000000000000GS00000
0G0000000T0000000S00S000000000
0000000G0000000000000000000T00
G0000000T000000000000000000000
0000T000000G000000S000G0000S00
0000000S00T00000000000G0000000
000000G000000000000000000000GT
0000T000000000000000000S000S00
T00000000000000000000000000G0S
0G0T000000000000000000000G0000
000000000000T00000000000SS0000
