0tS0000000g0S00000000000000g00
0gS000000000000000000000000000
000000000000000t000000g0000000
0000S0000000000000g000000000S0
g00000S0000000000000t00000000S
0t00g00000000000000000g00000S0
00000000000t00g00S00g000S000B0
000g00000000000000000000S00000
g000000t0g000000S00000000S0000
000000000000t0000000000000S000
0000000000000000St00000g000000
000S00000g0000g000t00000000000
0g0t0000S00000000000000g000000
0000t000000000000000000000000S
0S00000000000t00g000000000S000
000g0000000000000000000g000000
00000000t00000S000000000000000
000000g0t000000000000000000000
0000t0g000000S00S00000000gM000
0000000g00g000000B00000000S000
0S00000t000000000000S0000000g0
0000000000000g0000000000000000
0000000g0000000S0t000g000000B0
000Sg00g0000000000SM000MB00000
0000t000S000000000000000000000
0g00000t0000000000g000BB00000S
00g000000g0000S00000t000000000
00S0S00000t0M000000000g0000000
0000000000000000000t0000g00S00
00000000000t00000gS00g00000000
