00000000g00000000000g0t0000000
t0000000gS0000000S000000000000
00000000g00000000000g00000B000
000000000000000000000000000000
000000000g00000000000000000000
000000000000000000000t0S000000
000000000000000000000000000000
000000t00000000S0g000000000000
000000S0t000000000000g00000000
0000tg000000000S0S0000000g0000
t0000000000000000g0000000000g0
S0000t00SM000000000000g0000000
00000000000000000000g0000000g0
000000t000000000000000000000g0
tS0SM0000000000000000M00000000
0000000tg00000000000000S0000S0
0000000000000000000t0000000000
0St00000000000g00000S0g00M0000
00g00t0000g0000000000S00000000
000000gt0000000000000Sg0B0000B
0000000000000S00g0000000000000
00000000g000000t000000g0000000
0000000000000000000000Sg000S00
000t000000g000g00S000000000000
00000t00g0000SS0000g0000000000
0000g0S0000000000000S000000gB0
00S00000S000M000g000000000g000
t000000000000g0000000000000000
000000000t000g00000000000S0000
0000000000000000g00g0000000000
