000t0000S0S0g00000000000000000
000000000t0S00000000S000000000
0S000gg000000t0000000000000000
000S000000000t0ggB000000S00000
Sg000000000t0g0000000000000000
00000000000t00000000000000g000
00000g000000000000t00000000000
0000000t00S0000000000000000g00
000000000t00g0000000000S0000g0
00000000S00000tSM000000g000000
t0000000000g00000000000g000000
00t000000000000000000000000000
0000000000Sgt000S00000g0000000
0t000000000gg000SB00000000B000
00000000gt00000g0000000S0B0000
00t000000S00000000000000000000
0000t00000000000000Sg000000000
000g00000S0t000000000000000000
S00000000000000000000000000t00
000000g000000000000000S00g000S
g00000000S0000000000000000t000
0000000000S0000S00000t00000000
000000000000tg00000000000000g0
00000000000S00gt0g00000000000B
00000S000000000g00gt0000000B00
S000000000tS0000M0000000000000
g0000000000t000000g000000S0000
000t00000000000S00000000000000
t0000000000000000g0S0000000000
g000000000000000000000g000S000
