000g0t0000g0000000000000000000
0000000000t0000000000000000000
000000000000S000000000000000S0
0g00000000000t00g0B00000000000
000g000000000000000t0S0S0g0000
000t00000000g0000S000g00000000
000g000000000000000000g0000000
0000S0g000000t00g00000B00S0000
S00000000S000000000g0gt0000000
0Sg000000t000000000S0000000000
00g000000S00000g0t00000B000000
000000000g000000g000000000t0B0
00000000000000000000000000000S
0g000tS0000000000000000000000g
000000000tS0000000000000000000
00000000000t0SS00000000000000g
000000000000t0000000000g000000
0000000000000000000g0000000000
00t0000000S00g00g00000000000B0
0000S0t00000000000000000000000
00000t0000000000000S00S0000000
S00t00000000000g00000000000000
000000S00000S00000000000000000
0t00S0000000000000000000000g00
000000000000000S00000000000000
00000000000000S0000000S0t00000
0000000S0ggt000000000000000000
000000000000000000g00gt000S000
00000000000S00g0g0000000000000
0000S0000000S000000M0000000000
