000000t0000000g00000000000S000
00000S0000000000000000000S0000
000000S0000t00000000000g0000gB
0S0000S0g00000000t00000000g00M
0000S000000g000000000000000S00
00000g000000000000S00t000g0000
t00000S0000000000000000000g000
0000000000g0000000t00000000000
S00000g00000S000000000000000tg
00000t00S00000000g00000000S000
000tg000000000000000g0000000S0
0000t0000000000000000000000S00
000000g0000g000000000000B00t00
0S0t0000000000000g00000S000000
000t000S00000S00M0M000g0000000
00000t0000000S00g0000000000000
00000000000000000000t000000000
0000S00000000t00000S0000000000
0000000000000000S000t000g0g000
000000g000000g00B000t000000S00
0000000St000000000000000000000
00000000000000000S0g0000000000
0000t00000g00g0000000000000000
00S000000g00000000000000000000
00g0g000000000000000000000B000
0000000000000000000g00000000S0
000000000gg0000000S00000000000
tSg0000g00000000000B0000000000
000000g0t0000gB000000000000000
00000000000g000tS0SM0000000g00
