G00T0000000000000000G0H0000000
00G00000000TG000000000000S000H
T00GS0G0000000000H0000000S00H0
G00S00000S0T000000000000000000
000T00000G000000000000000G00S0
000S00S000000G00000000000C0000
00000000G0000000000G0000000000
0G00000000S000000G0000H0S0HH0T
G0000000000000S00000S00000000G
0000000000000000000S0000000000
000000000S000000000000000T0000
0000000000T00000G00000000000G0
0000000000000000000000G0000000
000000000000000000T00000000000
0000000000000T0000000000000000
0000000000000000G000G00T0S0H00
0000G000S00000000G00HS00000000
0000000000000T0000000000000000
000000000000000T0000000G000000
000000000T000000000000000G0000
00000000000000T0000000000S0000
00000000T000000000G0000S000000
00S000000000S000G00G000000000C
0T000000000000000G0000S0000000
0TS000000000G000000G0000000000
00000000000000000T0000S0SG0000
000000000000000000000G0000000G
00000000000000000G000000GS0000
S000000G000S000000C00000000000
S0000000S0000000000000GG00T000
