000000T0000000000S00S000000000
00SG00000000000T00000000000000
0S00G000SCT000000000C0000C0000
000T0000G000000G00000000000000
000G0G000000000000S0T00000000H
0G00000000000000000000000000G0
0GS0000T00000000G0000000000SC0
S000T000GS0G0000000000HC00000C
0G0T00000000000000S00000000000
0000000T0000000000SG0000000000
00S000S0000000000000000G000000
0S00G000000000000000G000000000
000000S000000000000000T000G0G0
0000000000T0000000000000000000
000000000000000000000000000000
00000000T00000GS000000GH00000S
00S00000000000000ST0000000000C
0000000000000T0000000000000000
0000000T0000000000000G000G0000
00000T0000000000000S0000000000
000000000T00000000000000000000
00000S000SG000000G00000T000C00
00000T0000G00G00000S0000H00000
000000000T000G00000GH0H0000000
0G000000000000000T000000000000
0000000S000GG0000S000000000000
0G0000000S0000000S0G0H00000000
0000GT0000000000000G0000000000
T00000000000000000000000000000
000G0T000000000000000000000000
