T0G00000000000000000000S000000
0000G0000000000000000000G00000
0S0SG000000000000C0000000C0000
000S00000000TG0S000000000G0000
000000000T00000000000000000000
000000G000G00T00H0000000S00000
000000S00G000000T0000000000000
000000000G00T000000000S0S00000
00000000000000000T000000S0G000
0T0000000000S00000S000G0000GH0
00000000G000000000G0T000000000
G000000000000000000G00S0000000
00000000000000000000T0G0S00000
00000T000000000G0000000000S000
000000000S0G00000000S000000000
000000000000000000000000000GG0
00000000000000000000G0G0000T00
00S00000G000000000000000000000
0000000S000000000000000GT00000
00S0T0000000G0G00000S00000000H
0000000S00000T0000000000000000
0T0000S0000000000S000000000000
00000T000000G00000000000000000
000T000000000G000000000000000G
0S0000000000000000000000S0000G
000000000T0S000G00000000000000
000000T0000000000S000000000000
T000000000G0G0000000000000S000
0000000000000G0T00000000000G00
0G0000000000000000000S0SG00000
