000g00t000g0SB0S000M0000000000
00g0000St000000S000M000000g000
000000000t00000000000000000000
g00000S000S0000000000000000000
000000000SS00g0000000000t00000
000000g000000000000000000S0Sg0
00000000g00000000t000000000000
0000000000000000g000000t00g000
0S000g0t00000000000000000S0000
0000000000g000000t000000000000
0000000000t0g0000000000g000000
0S0000000000000g000gt0000B0000
0000t00S0000000000000000000000
00t00S00g0000000000g0000000000
000t000000000000000S00g0000000
00000000t00S000g00000000000000
00gt00S0000000000000000000S000
000t00000000000000000000g00S00
gg00B0000000000t00000000000000
0000000S00000g000SM00000000g00
0000000000000t00000000000gS000
0S000000t00000S00000000000M000
000000t0000000000Sg00000000000
00g00000000t000000000000000000
000000000t00S000g0000000000000
t00000000000000000000g00000000
00000000t00000000000000000000g
0000g000S00000g00000000t000000
St000000000000000000000000000S
g00gB0S00Bt00B000000000B000000
