0000000000000TG00000000S00G0H0
0000T0S0000000000000000S000000
0T00000000000G00000000S0000000
0000000000T000G0S00000000S0000
S0G000T00000000000000000000000
0T000000000000G00G00000S000000
000000000000000G000000G00T0S00
00000000S00000000T0S0000000000
000000000T00000000000S00000000
000000000000000S0S000000000T0C
000000000000010000G000000S0000
00000000000000000G0000000000G0
0000000000000000000G0T00000S00
0G000G0T0H0S000000000000000000
00000S000000T0000000S000CG0000
0000T00000000000G0000000000G00
00000T000000GGH000000000000000
0000GTG000H00000000000H0000000
000T00000000000000S0000G000000
0000000S0000000000000000S00000
0000000S0T00SC0000000000000000
G00000G0000000000T00S000H00000
00T000000000S0S00C000000000000
TG0G0000S0000000S0000000000000
00000G0S000GT00000000S00000000
00000T000G00000000000000000000
00000000000T0000000S0000000000
0000000000000000000G0T00000000
0000T0G0000G0000000000000S0000
000G00000000T00000000000000000
