00000000S0000000000t0000000g00
000g0g00B00000000000B000000000
00000g000000000000000S00000000
0S0S000000000000000t0000000000
000000g00000St0S0000000g0BM000
g0000000000SS000000000t000M000
t0000000000000000000000000g000
00S0g00t0000000g0000S00000M00M
0g0000000000000000000000000000
0000gg00000000B0S0S0t0B0000000
0000000000000000g0000t0S0S0000
000000g000000S000000000g000000
000S00000000000t00g00000g000B0
00t000000000000000S00000000000
000000000000000S000S0000000t00
000000000000t00000000000000g00
000000000000000000000000000000
000g00g0BS00000000St0000000000
0gtS00g0000000000000000000B000
t00000S0g000000000S000000g0000
00t000000000g0gS00000000000000
00SSgg0B000000000000000M000B00
000000000000S0000000t0000g0000
t000000000000000000g0000000000
S000t0000000000000000g000000SM
0000000g000000000000t000000000
00000S00000000000g0S0000000000
S00000000000000t000000S0000g00
00000g0000000000000S0000000000
00000000000g00000000000t000000
