0000000000000000000000000g0000
00000000t0S000000000000000S000
g0g0000000000000000S00000000t0
00gS0000000000000000g000tS0000
0S000t00S0000000000M00M0000000
gg0000SS0B00000t00000M00000000
0000000t000000S00000000000S000
00000t000000000000000000000000
000000g000000S0000t00000000000
000000000000000000S00000000g00
000000Sg00000000000g00000S0B00
000000S00000000000000000000000
00000g0000000SS000000000000000
000000000000000t00000000000000
00000000000000000S0000000g0000
0000000S0000000000000000000000
00St000000000000000000S0000000
S00000000000S00g0000000000000t
000000000t000000000S0g00S00000
0000000S0000gt0000000S000000MM
0000g00t00000000000000000g0000
000S0t00000000000000g000000000
00000000S0000t0000000000000000
t000g00000000000g00000B0000000
000000000S00000000S00000g00M00
00000000t0000000S0000000000000
0000g0000000S00000000000000000
0g000000000000g0000000S0000000
gg000000SS0000000000Bt0000M000
0000000000g0000t00000000000g00
