000000000000000S000000000000t0
00000000t00000S000S00000000000
0000t0S000000000000000000000g0
000000000000000000g000t0g00000
0000000000000000000S0t00000g00
0000g000000000t000000000000000
000000000000t0000000000g000000
0000000000000000g0S0000g0t000B
0g0000000000000000000g000Bt00B
0S0S0000000g0t0000000000000000
0t000000S000000000000000000000
g000000000000000000gSt00000000
00000t0000000000000000000g0000
0gS0000000g0S00M000M00t00000B0
g0000000S0000000000000tg00B000
00000gt0SS0M000000000000000000
t0000000000g000000S00000000000
t000g0000000000000000000000000
000000000000000000g00000000000
00000000000000S000S0000g000M00
0000St000g000000000000000g0000
0000000g0000000S000000000SM000
Sg00Sg00Mt000B00000BB0000M0000
000000000000g00000S0000t000000
00tS00000S00000000Mg0000000000
00S0000t0Sg00000g000000000M000
000t0g000000S000g000000B000000
0000000St00000000g000S000Mg000
g000000000000000000000000000g0
t00000000g000S00g0000000000000
