0000t0S000000S0000000000000000
S00000g0g000000000B0S0M0000000
00S00000000000t000000000000000
0000000000t000000000000000000g
00000S0000000t000S00000000000g
000000000000000000000000S00000
000S0000000000000000gS00000000
0000S00g00S0g00000000000000000
000000000g000000t0000000000000
0S0000000000000000000000S00000
g000000g0000t00000000000000000
000000000g000000000g0000000000
0S00t000000g00000g000000000000
000t0000000000S0000000S0000000
g000000S0gt00B0000000000000000
t000000000000000000g0000000000
tS000000000000000g00g000000000
t00000000000g0000000000000S000
0S0S000t000000000000000000000M
00g0000000tg000000000000000000
0000000t00000000000000g0000000
000t000000000000000000g0000000
00t000000000000000000000000000
t00000S0000000000g000000S00000
S0000S00t00g000000M00000000000
00000000ggS0000000S0M000000000
000t000000000g000S0000S0000000
000000t000g0S00000000000000000
000000St0000000000000000000000
000000000000000g000t0000000g00
