000g00000t00000000000000000000
0S0000000000000000t0000g00g000
000000000000000g000000t0S00S00
S0t00000g000000000000g00000000
S00000S000000g0000g00t00000000
00S00000000000t0000000000S0000
00000000000000000t00000000gg00
0000000t0000000000000000S00000
00000S00tg000000000000000S0000
000S0000000000t00000000g00g0B0
00S000000000S000t0000g00000gB0
g0000000000000S00000000g000000
000S000t0000000000S00000000000
00000000g0000000000S0000S00000
00000Sg00000000000000000S0Mt00
000000000000S00t0000S000000000
000000000000000000t00S00000000
0000g0t0000000S000000S00000000
0gS000000000S0M000000t000g0000
S0000000Sg000t000000000M000000
000000000000000000000000t00000
S0S0000000t000000M000000000000
000S00000gt00g0000000000000000
0g00000t00000g00000000B000000B
000000g0t0000000000S000000g0B0
0000S00S00000t0000M0000M000000
0g00S00t000g00000000000000S000
00St00000000000000000000000S00
000g0000000000000000000000000g
00t00000S00000000gg00B0000S000
