00S0000000000000000ST000000000
0T000000000000000000G00S000000
S0000000S00000000000G0C0000000
000000000T00000000000000000000
00G0000000T0000000000000000000
00S0000000000000000000000000G0
0G00000G000000H000000S0000H000
00G000000000G00SS00H0000000000
0000T0000000000000000000000000
00000S00S000T00C0G0000C000C000
000000000000000000ST0000000000
00T0000000G0S00000000000000000
G000000S0000000G00000000000HS0
00000000000G0S0000000000000000
0000000000000ST000000000000000
0G000000000000000000SS00000000
000000000000000T000000000S0000
00000000000000G000000000S00000
000000G00000000000000000000000
SS00T0G0000000000000000G000000
G0000000SG0000000000H0T0000000
0000000G00000T00000000000G0H00
00000000T000S000000S00G0000000
S000GG00000H000000S0T0000C0000
0000000000000000000000G000G000
00S0000000000000T00000G0000000
0000T0000000000SS0000000000000
000G0SG000000000000000T0000000
00000T000000000000000000000000
0000000SS000000000C00000C00T00
