000G000000000000GT000000000S00
S0000T00000000000G00G000000000
000000TG0G000000000S0000000000
000000000T00000G00000000000SS0
0000000S000000000000S000000000
000000000TS00000000S0000000000
00000000000G0000GH0000000T00H0
00T00000000000000000S0S0000C00
00000T0000000000000S00000000G0
000000000000S0G00000ST00000C00
S0000000G0T000000000000SG00000
00S000000000000000000T00000000
T00000000000000000000000000G00
T00S0S0C0000C0G0000000000000C0
0S00000G000000S00000000TG000C0
0S00T0G000S0000000000G00000000
00S0T0000000000S000000000000G0
G0000000000000000T0000000G0000
000000000000G00000000000000000
0000000000000000000G00000000T0
0000000000T00000000G0000000000
000000000000000T000000000S0000
00G000000000000T0G00H000000000
0G00000000T0000000000000000S00
000000000000000000000S00000000
00000G00000000000000000S00S000
0S0000000T00000000000000000000
0000S000S000CT000C000000000000
000T000000000000000000S0000G00
00000000S0G0S0G000H0000000000H
