T00000000000000000000000000000
000000000S0000S000000000000000
S0000ST000000G0000000C0000000C
SG00000000G00S00000000C0000000
G00000000G0H00000000000S000000
0000000000000000S0000000000000
S00000000000T00000000G000000S0
0000G000S00T00000000G00000H0H0
00000T0000000SS0C00G0000000000
00000000000G0T000GS00S00000C00
00G0S00000000000000000000T0000
00ST000000000G0S000C0C0C000000
00SG000000000000SG0T0000000HHH
0000000S00000000000G0000000000
0T00G000000000000GS00000000000
00000000000000G00000000S00T000
0000000000S0000G0S000000000000
0000S0T000S000000000000G0GH00H
0000S00000000000G00000000T0000
0000000T00000000000000000G0S00
000G000T0000G0H0000000000H0000
000000S00000000T00S0000C000000
0000000G0000000000000000000000
0000000000000000G00G0000000000
000000G0000000000000S000000000
000000000000000S000000G0000000
G0T0000000000000000000000000S0
00000000000000G000000000000000
0T000000000G00000000000000000S
000000000000000000000000000T00
