0000000000000000g0000000g00000
g000Sg000000000000S000000000M0
00000g000000000t0g00S00S000000
0000000000000t00000000000g0000
000000000Sg00000000000000000S0
000000000t000000000000S0000000
S00000000S000gM000t0M0M00000g0
000000000000g000t0000000g00000
0000000000000gtS00000000S00000
00000000g0000000000000000t0g00
t0000S000000000000000g00g00000
0SS000000000g0g000000t00000000
000000000000000t0000000000g000
0000000000000000000000000000St
000000000000t0S0000000000g00g0
0000000000000gt0gS0S00B0000B00
00S0g00t000000000000000g000000
000g00000000000000g00000000000
00000t00g0000S000000g0000S0M00
000000000000000000t00000S00g00
000000000000g0S000000g0t000000
0000000gt0000S000000000000g000
00gt00g00000000BS0B000000B0000
00g000t000g0B00000000000000000
0000S0t00000000000000000000000
0tS000000000000000000000000000
0000S0t000000000000g0000000000
S00000000000t00000000000gg0S00
0g000000000000t000S00000000000
0000000000000S0000S00000g00000
