0t000S0000S00000000000000M0000
00000000000000S0t0000gg0000000
000S0000000Sg00000M00000000000
000t00000000g000000000000S0g00
0000000000S0000000t0S000M00000
0000t000000000000S000gS0000000
00000000S000000g000g00000S0M00
000000gSt000000000000000000000
00t00000000g0S0000000000000000
0000g0000t000000g0B0000B00S000
0000t0000000000000000000000g00
000t000000000000000000000Sgg00
0000Sg00000000000000g00000000S
000000t00g00000000000SS00M0000
00000000000t0000000Sg000000000
0000gS0g0t0000000000B0B0000000
0000000t0000000000000000000000
000000g000tSS000000M00000000g0
00Sg0g0000S0000t00000B00000000
000000S00S000000000000000g0000
00tS00000000000000000000000000
000000S000S0000000000000000000
0000000000000000000000000g0000
0000000000000S0000S000000g0M0M
g00S00S000t00M00000000M000g0M0
000t000000000000000g0000000000
g000t0Sg0000000000000000000000
000000S0000000g00000000S000000
0000t000000000000000000gS00000
0g000000000000000t00000gS00000
