S00000t00000000000000000000000
000S0000000000S00000000Mt0000M
000t000S0000000S0g00000000000M
0000000000000gg00000000S0000B0
t000000000g0000000S0g00000000B
0000000tS0000000000000000000S0
t00000g000000g0000000000000000
00000t0g0000000000000000000000
t0000gS000S000M00000M000000000
00000000S000000000t000000000S0
000S0000g00t00000000000000000S
00000000S0000000000g000000000g
00000000000000000t000000000000
00t000000000S00Sg0000000M00000
000000S0000000S000000g00Mt0000
000000000000000t0S0000000g0S00
000000000000000000000000000g00
00000000g00000000Sg0000000B000
0gg0000000000000S000000t0S0M00
g000000000000000S000000000S000
000g0000000S000000000000000000
S00000000000000S000000000t0000
000000000000000000000000t0000g
0000000000000000g0000000000S00
t00000000000000000000000000000
S00S000000Mg0000gB00t000000000
000t000000000000000000S0000000
00t00000S000000000000000000000
000000t00000S000g000Sg0M000000
000000S00000g00t0S00000M000g00
