00000000gS0000gS00000000M00000
t0000S00000S000000000000000000
000000g00gt000000B000000S0000B
0g0t000S00g0B0000000B000000000
000000000000S0000000t00000S000
00000000000000000t00gg000B0000
00000g00000S0g00B0t00000000000
0g000000000000000g000t0000000S
00000g00000g0B000000S000000B00
000S0000000SM0g000000000000000
0S00S0000M0t0M00M0000M00000000
0t000000000S000000000000000000
00g000000t0Sg00000000B00000000
0g0000S00000000000000000000000
0S000000g0000000g0S0000000M000
00000S00000000S00000t000000000
g0000000St000S000000000M0g0000
00t0000000000g0000000000000000
g000S0000000S000000000000g0000
0000g0000S00000SM000000000M000
000000S00g000000SgB00t00M0BM00
00000gt0000000SS000000000000M0
00000000t000000000000000000000
000000000000000000000000Sg0000
00g000000000000000000000000000
00g000S000000000000g0000000000
000S00000t00000000g0000g000000
00000S0000000000g000S000000t00
S000000000000000000g0000000000
00t000000000000000000000000000
