00000S00S000g00M00000M0g000000
t0000000000000S000000000000000
00g00t00000000g0B00000B0000000
0t0000000000000000000000S00000
00000000000000tS0g00000000000S
0000000g0t00000000000000S0g0B0
0000t000000000S000S000M0000000
g00t000SS000000000000000000g00
g000000000000000000000S0000t00
0000000000000t000g0g000000B0B0
0g000000t000g000000S000000S000
g0000000S000000000000g00000000
0000gg0000S00t000000000B000000
t0g0S0000gS00000000000000B0000
00g00St000000000000000g0000000
000000000000000S00t00000000000
00g00t00000000S000000000000000
0000000000S00000000g00000t000S
0000t0000000000000000000S00000
000000000g0g0t00B0B00000000000
00000t000000000S00000gg0000000
000000000t00000000000000g00000
0000000000000000S0000t0000S000
0000000000g00000t00000000000S0
000g000000000000000000g00000SS
000g000000gt00S0S00000000000M0
0000tg0000S00000000S0000000000
00S000000000000000000g00000000
00Sg000000t00000000000000S0g00
00000000S000000S0000gt00000000
