00000000000000000000t0g0000000
0000000000S000000S0000000t0000
000000000000000000g00000000Sg0
000000000000000000000St0000000
000000000000000S00000000g0S000
00000000000000g000000000000000
00000000000gg00B00000000000000
00000000000000000000000000S000
000000g00000000g00000000000000
0000000000gSt000000000000000S0
000S0000000000000000000000t000
000t0000g00000S0000S00M0000000
0000t00S0g000000000S0g00000000
00S000000000000000000000000000
0g0000000000gt0000B00000000000
g00000000000000000000000000000
0t0g00g00S0S00000000000B000000
000000000000000g0000g000000000
t0000000S0000000SM00000g000000
0000t0g00000000000000S00000000
000000000000000g00000S00000000
00S00000000000000t00000g00S000
00000000000S000000000000000S00
000S00000000S0000M000000000g0g
00000000000000S00000000000000S
00000000000000000000000000g000
000000t0S000g0000000000S000000
0000000S00t00000000Sg000000000
00000S000t00000S0000000000000M
000000000000Stg00SM0000M0000g0
