00000t00000000S00000gg00B00SB0
000S0000S00000000000g000000000
00000000g00g00t00000000000B000
000000000000000000S00000t00000
000t000000000000000000000SS000
g00000000000S0S0000000000t0000
00000000000SStg0M000gM0000M000
0Sg000S00000000000000000000000
000000St00000000g0000000S00000
0000000t00000000g00S0gB0000000
000000g0000000000000000g0000S0
00t0000000000000000000S0000000
t0g000000000000000000000000000
g0000000000g000000000000000t00
00t000g00000000S000000S0000000
000000000000000000000000000g00
0000000000000S00g00S0000000000
0000000t0gg00000000000000S000B
000000000000000S0000000S000g0t
000000000g0tS000S00M0000000000
00000t000000g000S0000000000000
00S00000S0000000M00000000000M0
0g0g0B000000000S00000000000000
g000000t0000000000000000000000
0g000S0000t0000000000000000000
0S000000t000S00000000000000000
0000000000000t00000000S00000S0
0000000000t000000g000000000000
00g0000000000t0g00000BB0000BS0
0t000000000000000000000g000SS0
