G00000000000000000000G000H0S00
000000S000000G000S000000000C00
T00000G000000000G00H00000H00S0
0000000000000000000000G0000S00
0000GS000000S0000T000000000000
00S0000000000G0000000G000S00C0
000G00000000T00000000000000000
0000000000000S0000GS0000CG0C00
0000000000000G00T0000G0000000S
0T00000G0S0000G000000000000000
0T00000000000000000S000000S000
00T000000000000000000G00000000
00000000000000000G000000000000
0000G00G00H00H000HH0H000000000
0000S000S000000C0GTG0000000C00
0000T0000000000S000000S0000000
0000SG00000T000000000000000000
0000G00000G00000000000T0000000
00T0000000000S0000S00000000000
T0000000000000000000S000000000
S000000TG000000S00000000000000
00000T00000000000000000S0S0000
000000TG00000000000000S00SG000
00T000000000000G000S0000000000
000000000000000000000000000000
S00T00000G0000000000000S000000
00G000000000000000G00000000000
000000000000000000ST000S000000
00000000000000T000000000000000
00S000000000000T0000000000000G
