0000t00000000000000000000000SS
0000000000000000000000g0000000
0S0000000S0M0t0000000000000000
00000S00000000000000000000000t
000g000t00000g0000000000000000
00000000000000000000000S00St00
0000t000000000000000000S0S0000
00t0S0000000000000000000000000
t0000000000000g0g0000000000000
0000S0000t00000000000000000000
000000S00g0S0000000000Mt0000g0
00000000000000g00000000S000000
0000000000S00t00000000000g0g00
00000g0t0000000000000000000000
00000000000000000S0000t0000000
00000000000000000000gg00000000
0000000000S0000000t00000000000
0g000000000000S0S000M0000g0000
0S000000000000t0000000000S0000
000S00000000S0M0000000000000M0
00000t0000S0S00000000000000000
000000St000g0000S000000000000g
S0000000000t0000000000000000g0
g00000000S0SMgB000B0t00000M000
0000S00t0000000000000000000000
000000S00t0g000000000000000000
000g00000gS0000S0000000000000t
0000000g0000S0000000000S000000
000000000000t0000000S000000000
00000000S00t000000000000000000
