0000000000S00000000000000000t0
SS000000t00000M000000000000000
000000000000000000000g00000000
00t00g00000000000S00000000000g
00000S00000000000000000000S000
000S000000000t0000000000000000
0000t000000000000000000Sg00000
000t00000000g0000000000000S000
t000000g000000000S000000000SM0
S00S0tM00g000M00000000g0000000
S000000000000S0000000000000000
00000000t000000000000000S00000
SS0000000M00000000000gM0000000
000000tS0g0000000000000g000000
00000S00000St00000000gg0000000
S0gg00000000000000BS000000000M
00g0S00S00000M00000000t0000000
g00S00000000000000000000000g00
0000g000000000g00St000S0000000
0t00000000000S00000S000000000g
00t000g000000g000000000000S00S
00000000000t000000000000000000
0t00000000000000000S0000000g00
0000000000t0g000000000000000S0
0gtSg0B0S0000B0000000000000000
0tg0S0000S0000g0000B0000000000
00t0gS000000000S00000000000000
0000gt0000g000000000B000S00000
000tg0000000000000000000000000
tgS000000000000000g00000000000
