000000000000000000000000000000
T0000000000S000000000000000000
0000000000000000000T0000000000
000000G0000000000S000000000GH0
00000000000000000T000000000000
000000000000T000000000SS000C00
00000S000000000000000000000000
0G0S0000000000000S000000000T00
0000000000000000000000000G0000
00S00G000G00S0000000000000000C
000000ST00000000000G0000000000
00T000000000G00S00000000000000
T00000000G000000000000G0000000
00000000000G000S00000000000000
0000GT0000000S0000000000000000
0ST0000000000000000000000000S0
0000000S0000S00000000000T00000
G00000000000000000000000000000
00000GG0H000000000H000T000S000
G0000S00000G0TH000000000000000
SG0T00S000C00000000000G0000000
00T000000000000S000S0C00000000
000000000TG000000000G00000S0H0
0000000000000S0T00000000000000
0000000000000000GG0000000T0000
000T0S000000000000000000000000
000000000GT00000000G00000000S0
0T00000000000000G00000000S0000
0G000000S0S00000000000000000G0
000000S0000000T00G0000G0000H00
