0g000000000000000000g0000000B0
000000S00000000000000000000000
0000000000000000S00000000t0000
00g00g00000000B00S000000S00000
0000S00S000000t0g00M0M00000000
000000000000g00000000000t00000
0000000g0000g0000B000000000000
0g000000000000g00S0SB000000000
g00SS00000000000000000t0000000
0S0t0S0000000000000000000g000g
00000000000t000000000000000000
00000000000t00Sg00000000g00000
0000000000t0000000000000000g00
000S0000000000000000000000g000
00000S00000000S0000000000000M0
0S00000000g000000g0000000t00B0
000S00000t0000Sg00M0gB00000000
000000000000S0S000g0000000t000
000000S0000t0000S00MM000000000
00000t0000gg000000000000S00000
0000000t0000000000S000000S0000
00000000000000000S0000gg000000
t0000000000g00000000000000S000
00000000000000000000000000g000
000000000000St00S0000000000000
000000000000g0g000000t00S00000
0t00000000000g000000S00g00000S
00t000000000g00000000g00000000
00000g0000000000000000000000S0
g000000000S0000000000000g0t000
