00000000t000000g0S0000S0000000
00S000000000t000S0000000000000
0000000000000S0t00000g00000000
00000000S00000000000t000000000
000000000000000000000t0000S000
0000g00000S00000000t0000000000
ggt00000BS0000B0000000000BB000
00000000000000g00000t000000000
0t00000S0000000000000g00000000
S000S000t000000000000000000000
0t0000S000g0000000000000000000
00000t00000000000S0000g00S0000
S00g0000t0000000g0000000000000
g0t000000g0000000000000000000S
000t00000000S00000000000000000
g000St0000000000000g000000B000
000g000000S00000000t0000SM000g
00g00000t0000g0S00B00000000B00
000000000000000000000Sg0g0St0M
0000St00000000000g000000000000
00g000t000000000000000000g0000
00000000S0g000000S0000t0000000
00000000000000S000000000000000
000000S0000000000000g000000000
00000S0000000g0000g00000B00000
000000000000tS0g00000000000000
000000000g00t00000000000g00S00
0000t0000000000000000000000000
000000S00000g000000t0000g00S00
0000Sg0000t00g0000000B00000S00
