00S00000T000000000000000000000
000G000SS00000C0000C0000000000
00000S00000000T00000000000000S
00000000000000000000000000000S
T00000000000000000S000000000S0
00000T00G000000000G00000000000
000G00TS00000S0000000C0000G000
0000000000T000000000000000S000
G000000S0000T00000000000000000
00G00000000000000000000TG0S000
0000000000000TS0000000000S0000
00T00000000000000G000000000000
0S00000T0000000000000000000S00
S00S00G00G000000CT00H000000000
00S000000000000000000T00S00C00
S0000S0000C0G000000000G000000H
00G000000000S0T0000000G0S00000
0GG000H000H00000000000SH0S0T00
00000000T000000000000S00000G00
0000G0000000000T0000000000000S
00G00000000S00000000000000S000
0000000000000000000S00000S0000
00G000G000000000H0000000000S00
T000000000000G00000000000S0000
0T00000000000S00000000S0000000
0G000S000000GH00000000H0000000
000000S000G0000000000000G00000
0000000SG000000000000000000000
000000000000T000000000000000G0
0000S000000000000GS0G00000C000
