0T000000H00000000000
00000000000000000000
000G000S000000000000
000000000T0000000S0G
000S000000G000000000
00000000000000000000
00G0S0000000000T0000
00000000000000000000
000S000000S000000T00
000G0000000000000000
00000000000000000000
000000T00000000G0000
00000000000000000000
00000000000G00000000
000S000000000S0000T0
00000000000000000000
0000000000000000S000
0000G0T0000000000000
00000000000000000000
000000S00000000S0000
