0G000000000G00000000
00000000000000000000
000000T0000000000000
000000G00000S0000000
0S000G00000000000000
00000000000000000000
00000000000000000000
00000000000000000000
00000S0S000000000000
H0000000000000000000
00000000000000000000
G00S0000000S000000S0
0000G000000000000000
00000000000000000000
00000000000000000G00
0T000000000000000000
00000000000000S00000
000G0000000000000000
00000000000000S00000
00T00000000000000000
