000000000H00000T0000
00000000000000000000
000T0000000000000000
0S000000000S0000000S
0000000000000000000S
0000000G00000G000000
00000000000000000000
00000000000000000000
0T000000000000000000
00000000000000000000
0000000000000000000S
000S0000000000000000
00000000000000000000
0S000000000000000000
0000000G000000000000
00000000000000000000
00000000000000S00000
000G0000000000000000
00000000000000000000
GGG000000T0000000000
