00000000000000000000
0000T0000000GG000000
00000000000000000000
0T000000000000000000
00000T000000000S0000
00000000000000000000
000000000S0000000000
H0000000000000000000
000T0000000000000000
0000000000000000000T
00000000000000000000
000S0000000000000000
0000000000000000S000
00000000000000000000
0000000GG00000000000
00000000000000000000
S00000000000000000S0
00000000000000000000
0000000000000GG00000
000000GGGG0000000000
