00000000000000000000
00000000000000000000
000000T0000000000000
T00000G00000S0000000
00000G00000000000000
00000000000000000000
00000000000000000000
000000000000GGG00000
00000T0S0000G0000000
0000000000000000000H
00000000000000000000
G00S0000000T000000S0
0000G000000000000000
00000000000000000000
0000000G000000000000
0T000000000000000000
00000000000000S00000
000G0000000000000000
00000000000000S00000
000000G0000000000000
