00000000000000000000
0000T000000000000000
00000000000000000000
0T000000000000SS0000
00000000000000SS0000
00GGG000000000000000
00GGG000000000000000
00000000000000000000
00000000000000000000
000000000H0000000000
00000000000000000000
000S0000000000000000
000000000000000T0000
000T0000000T00000000
0000000G000000000000
00000000000000000000
00000000000000000000
00T000000000000T0000
00000000000000000000
00000000000000000000