000S0000000000SS0000
00000000000000SS0000
00000000000000000000
000000G00000S0000000
00000000000000000000
000G0000000000000000
00000000000000000000
0000000000000G000000
000000000000G0000G00
00000000000000000000
00000000000000000000
G00S0000000T000000S0
0000G000000000000000
00000000000000000000
0000000G000000000000
0T000000000000000000
00000000000000S00000
000G0000000000000000
0T000000000000S00000
0000H0G0000000000000
