0000000S000000000S00
0000S000000000000000
00000000000GGG000000
00000000000000000000
0T000000000S000000T0
00000000000000000000
00000T00000000000000
00000000000000000000
00G0000000000000000S
0000000000000000000S
0T00000000000000000S
000000000000G0000000
00000000000000000000
00000000000000000000
00000000000000000000
00T0000000S000000T00
S000000000S000000000
000GG000000000000000
00000000000000T00000
0000S000000000000000
