00000G0000000T000000
00000000000000000000
00000000T00000000S00
00000000000000000000
000000000000G000000G
00000S00000000000000
0000000T000000000000
G000G000000000000000
00G0000000000S000000
0G000000000000G00000
H0000000000000000000
000G00T0000000000T00
00000000000000000000
000000000G0000000000
00T000000000000S0000
00000S00000000000000
00000000000000000000
000000000000S0000000
000000G0000000000000
0000000000000000000G
