0000000000000T000000
00000000000000000000
00000000000000000S00
000T0000000000000000
00000000000000S00G0G
00000000000000000000
0T00000000G00000000G
0000000000000000000T
00G00000010000S00000
00000000000000000G00
000000000000G000000T
00000000000000000000
000S0000000000000000
00000000000000000000
00000G0000000000S000
00000000000000000000
000000000000000G0000
00000000000000000000
00G00000000000T00000
0000T00000000000000G
