00000000g00000000000000tg00000
00gt0000gS000000B0000000000000
0000000t0000000000000000000000
0gt00g000000000000S0000000S00B
000S00000000000S00t0000M000000
000g000g0t000B0000000000B00000
00000S000t00000000g0000000000S
000tg0000000g0000000S00000B000
0t00000000g00000000000000000S0
00S00000St000000000000gg000000
0g00000t00000000g0000000000000
0g0000SS000MM000000000t0000000
00000000000Sg00S00000000000000
0000tg000000S00000000000000000
0S0t0000000000S00000000000000g
000000000000000000000000000000
000000t0000000000000000000S000
00000000000t00000000000g000000
00000000000t00000000000000000S
0000t00000000000S000g000000000
00000000g000000000000000t000S0
00000000000000000000000000g000
0000000g000000000t000000g000S0
0000000000000000t0g00000000000
000t0000S000000000000000000000
000g0000000000t000000000000000
0tS000000000000000000000000000
S00000000t00000000000000g00000
00000000000000000t000000000000
0tg000000000S00000000000000000
