000000000000t0000000000000S000
0000S0000000000g0000g000000000
00g00gt000000000000000000B0000
000g00S0000g000S00B0000M000000
000S000000000000000S0000000000
00000g000000000000t00000000000
0000000t000000000000g000000g00
00t000S000000000000000g00g0B00
000000000000000000000000000S0t
t0S0000000000000000S0000000000
00000S0t0S0000000000000g000M00
g00S0t00g0000000000000S0M00000
000S0000000000000000g000000S00
00000000000Sg000000S0t00000000
000000000000000SS0000000000000
gt00000000000g0000000000000000
00000000000000g0S00000t0000000
0S000g0000000S0000000000000000
000000000000S0g0000St00000000g
0000t0S00000g0g0000B000000000S
000g000000g0000000000000t00000
000000S00S0M0000000000g0000000
00000S00000t0S0000000g00000000
g0000000000000000000g000000000
000000000000000000S00S0t000000
000000000000S0000t000000S000g0
000000t00000000000000000000000
S00000000000000000gt0000000g00
gt0000000S000g0000000000000000
Sg0t00000000000S00000M00000000
