00000000000000000000000000t000
0000000000g00000t000000000g00B
0g000000t0000000S0000000000000
0St0000gS0000M0000000000000000
000000S000000S00000M0000000000
000000000000g0000g000000S00000
00t0000000S0000000000000000000
0gt0g0000000000000000000000000
00t00000S000000000000000000000
000000g000t0000g00000B0S00000S
0t00S0000000000000g0000S00MM00
00000000t000000000000000000000
t00g00000000S00S00000000000000
0000t00000Sg0000000g000000000S
00000Sg00g000S00000000000t0000
000000g000000g00B0S00000000000
000000g00000000S000S0000000000
000000g00000000000000000000000
000000Sg0000000000000000000000
000000S0000S000000M00000000000
0000S00000000000tg0g00000B0000
0g0g00t00000000B000B0000000B00
00tg0S0000000000g0B00000000B00
0S00000000000000000000S0000000
00000000000S00g000000000000000
000g00000000000000000g000000BS
g00000S0000t00S000000000000000
00000g0000000g00S000Bt00000000
0000S0000S000000000M0000000000
000000000g00000S000g0000000000
