0000000S0g0000g0000000000t0000
00000gg0B000000000000000t00000
00000000t000000000g000000000g0
000tg00g000B0000B00000000000B0
0000000000t00000000000S00000g0
00t00000000000S00S000000M00000
0g0000000000000000000000000000
00g000t000000g00000000S0000000
0000g0000S00000000000000000000
00000000000000000S000000000000
0000t00000000000000000g0000000
St0000000S000000g000000000Mg00
000000000t000000000000000000g0
0000000000000000S000000g000000
00000000S000000000000000000000
000000000000000000000000g00000
0S00000000000000tS000000000000
0000000t0000Sg0000000000S0M000
0tS00S0000M0000000000000000000
000000000000000000000t0S00gg00
g000S000Sg000tM0000000B0000000
0000g0000SS0000000000000000M0g
00000000g0S0000g00000000000t0B
t00000000g00000000000S00000000
00Sg0g00000000S00000000t000000
t000000g0000S00S00000000000000
0000000g00000000S0S0000g000000
0000000000t000000000000000000g
0000000g000000000t000000S000g0
000000S000t000g00000000g0000S0
