G00T000G00000000000000000000H0
G000000G000S0000000000H00TH00S
000000000S0S0G0000000000000000
G0T000000GHH0S00S0000000000000
00000T000000G00000G00000000000
T00000000000000000GS00000G0000
00S0000000T00000000G0000000000
0T0000000000000000000000S00000
00000G0G0000STS000000000000000
000000GG0000000000T0S0000000H0
0G00000000000000000000000S0000
0000000000000000000000G0000S00
00000T000000000000000000000000
S00000S0000000G000G00000000000
0000T000G00G00000S0H0HS0000000
00000000000T000000000000000000
0000S00000000000T000S000000000
0T000000G0S000000G00000S000000
G000S000000G000000H0000000000H
0000SG0000S00000000000G000T0H0
000T0000GGS000000000000000H000
0000000000000000S00S00000000C0
G000000G0000000000000000000T00
00000000000000000000SG00000000
000000000000000000000S0000G0T0
000G0000000000000000T00G0000H0
0000000000000000000000T0000000
0G00000T0000S000G0000000000000
000000000000000000000000000G00
00000GT0G000000000000000S00000
