00g000t00000g00000000000000000
g00000000000000000000000t00000
00S0000t00000000000S00g00g0000
00000g00000000S000000000000000
00000000000000000g000000000000
S000000000000000t00000g0000000
S00S0000g00000000000t000000000
000000000S0000g0000000000000g0
0000000000t000000000000S000000
S0000000g00000000000000t000000
SS00000M0000000000000000t00000
00S0000000g000000S0t0000000000
0S000000000000000t000000000000
0t00000000000000000000g0000g00
0St0g000000000000000000000S000
0000g00000000S0t00000000000000
0000000000000S0g000000t0000000
0S00000000000000000S0000000000
000000000000000t00g0000S000S00
00000000000S000000000000000000
000000000000tg00000000000000g0
t000000000000g0000000000000000
0000000000000000000g0000tg0000
00000S0000000g000g00B000000000
000t0000g0g0S00S00000000000000
0000000000t00000S000000000S000
t0000000000000000000000g000000
0000t0g00000000000000000S00000
0S00000t000000g000000000000000
0g0000000g00B000S00S00t0000000
