000000000000t0000g000000000S00
0t000S000000000000000000000000
000000000000St00000000g000000S
t00000000000S00000g000000g0000
000t00000000000000000000000000
00g0g000000000000000000S00000S
00000gt0000000000000000000S000
0000000000000000000t00g0000S00
0t0000000000000000000S00000000
00t0000000000S0g00g00000000000
0S00000t0000000000000000000000
00g00t0000000S00000000g00B0000
0000t00000g0000g000000000B0000
000000000000000SgS000000000000
00000000000g00000000000000g000
0000t000000S0000g0000000000000
00gg0B000S000000000S0000000000
000000000000000t00000000000000
00000S0000S00000M0000000g00000
g000000000t00g000000000000SS0B
000000000000000000000000t00000
000000000000g0000t00000S0g0B00
0000S0000S00000000000000t00000
000000g0000t0000000000000S0000
000000t000S0000g0g000000000000
0S0000t0000S000000000000000g00
00000000000000000000g000000000
0000000000000000000000t000g0g0
0000000000t000000S000000g00000
00S0000000000000000gS000000000
