00g0000000000000000000000000Sg
0000000000000S00t00S00M000M000
000000000000Sg0000000000000g00
0S000000000000g0000000000t0000
00S0000000t0000000000000000000
000000000g000S0000000000000000
000000000S0000S00000g000000000
0t00000000000000000g000g000000
000g000000000000000000S000000S
00000000t000000000000000000000
00g0S000g0000000000000000B0S00
0g00000000000t0Sg0000000000000
00S00g0000000Sg000000000B0MM00
0000S0000g00000000000g000000t0
00gtS00000000000000S00000M000g
0g0t000gB000B00000000000000000
000000000000000000000000000000
000S000t0000000000000000000000
00000g0gB000S00000000t00000000
00000000000000000000000000000t
0000Stg000000g0000000000000S00
0000000000t0000000000000000000
0000000000000g00000000g00000t0
00000000000000000000t00000000g
0000000g0S0000t00000S000000000
000t0000gS000000000S0000M00000
0000S0000t00000000000000000000
00g00t000S00000000000000000000
00000000000000000g0t0000000S00
00000S0g000000g00000S00000MBB0
