00G000000000000000000000S0000S
0GT00G000000000000000000000000
S0000GT000000S000C00G000000000
S0G00T00S000000000000G00000C00
0000G000GT00000000000000000000
0000S000S00000000000G00G00C000
000T0000000G000000000000000000
0000000G00S000000000T000000000
00000T0000G0000000G00000000000
00S00S0T00000000000000000C0000
000000000000T000000G0000000G0H
00000000000000S0S00TC00000C000
000000000000000G00G0HH0000T000
00000000000000T000000000000000
00G00S0000000000000S0T00000000
00T0000G0000000G00000000000H00
000000G00G0T0000S0000000H0S000
G000000000G000000T000000000000
00000000000000000G000000000000
000GT00000S000000G000000000000
0000000000G0000000000000G00000
0000000000000000000000000000T0
0000000000T00000000S0000000000
0000T00000000000000000000G0000
000000000GT0000000S00000000000
000S000G00000000000000000S000C
00000000GT00000000000000000000
0000000000000ST000SG0000G00000
000000000S000000G0000000000000
00TG0S0G0000000000000000000000
