0000G000000000S00000000000000S
000000000S0S00000000T000CG0000
0000S00S000000000000000T000000
00000000000T00G0S0000000000000
00000G000G00000T0000H000000H00
0000000T0G00S00000GS0H000C0000
000000000S00000000000000000000
0000000000T00000000000000000S0
0000000000000T0000000000000000
000T000S0000G0S00G000H00000000
T00000000000000000000000000000
0000000000000000000000G0000G00
000S000S00000G0G0H0000000TH000
0000000000T00000S0000000000G00
00SS00G0T000CC0000000C00000000
00000GT00000000000000000000000
S0T0000S00G0000000C000000C0000
000T000S0000000000000000000000
00000000000000000000ST0G000000
00000S0000000000S000000C000000
00S00000000000T000000000000000
000000S0T0G0000S00000000000000
000000000000T00000000000S000G0
0S0000TG000G00000H000H00000000
0G0G000000000000000000000000H0
00000000000T0000000000G000000G
000000000ST0000000000000000S00
00000000T000000000000G0S000000
0GT0000000000G0HH0000000000000
0T0000000000000000000000000000
