0S0000000000S0T00000000000C000
000000T00000000000000000000000
0S000G00T0000000000S0000000000
00000000000000G000000000000000
T00000000000000G00000000000000
0GT0G0S0000000S0000C0000000000
000000000G000S00G0000000000000
0T00000000S000000S0000G0G00000
S0000000T00000000000000S000000
0000000000000SSC00T00G0000G00H
00000SG0000G00000000S00T000000
0000000000000S0000000S00000000
000000000000SS0000C00000000000
0S0000000000000000T00000000000
0G000000000000T00S00G0000000H0
000000G0000000ST00S00000000000
0G000T0000G00000000000H0000000
000000000TS00000G0S0000G000000
T0000000S000000000G00S00G0000C
000000S000G0T00G00000S00000000
00000000000T000000000G0000000G
00000000000000000S00000T000G00
000000000S00GT00000G0H00000H0S
0GS00000000000S0000000TC000000
0000T0000000G0000000GS0000000H
000G00T0S00S0G000000H0H0000000
000S00000000G0000000S0000000GH
0000000000000000S00G0000000000
T0000000S000000000000000000000
0000000000G00000G000000000T000
