0000000gt00000g000S00B00000000
tS00000g0000000000000000000000
00000Sgt0000000g00000000000000
00g0000g000B000S00000000B0000t
00000t00000000S0g000000S000000
0000000000S000S00t000g00000000
0000000000000gS000t00g00000B00
0t0000000000000000000000000000
00000000000t000000S0g0000000g0
00000000t00S000000000000000000
0t0gSg00S0BB00000000000000000M
00000000t00000000S000000S00000
0t000000000g000000000000000S00
0000gtg00000000000B00000000000
0S00000000000t0g00000g00000S0B
0000000t0000000000000g00000000
000000S00t000S0g0000000000g000
0t00000000g0000g0000000S000S00
00g000000000000000gt0000000000
t000S0S00000000000000000000M00
0000g0000000000S000000S00000M0
00000000000000000S000S00000000
00g000000000t0S000000000000000
00000000000000g00000g000000000
000g000S000t000000000000000g0B
0gt000000000gB0000000000000000
00000000000t0S0000000000000000
0S000000000g00000000000SM00000
000000000000t00S0000000000000g
00t0000S00000000000S000000M000
