0S0000T0S00000000000000C00C000
000000G00S0000000000000000G0H0
00000G000000S000000S000C000000
G00000000000000S0S00C0C0000000
0T0000000000G0000G0000000H000H
S0000000G00G000000000000000T00
00000G00000000S0G00000000000T0
000000000000T0000000000000000S
000G000000G0T00000000H00000000
000000000000000000T00000000000
00S00T000000000000000000000000
00G000000000SG0000000000000000
000000000000S00S0000000000T000
0T00000000000G0000000000000000
0TS000000000000000000S0000GC00
00000S0000000000000000000S0000
0000S00000G000000000000000000T
0000000000000G0000000000000S00
0T0000S0000000S00G00000000G000
00000T0000000000000G0000S0S000
00S0G000S0000C00000GC000C0T0H0
00000000000000S00000T000S00000
00T000000000000000G00000GS000S
0000S00000000000000000S0000000
000T0000000000000000G000000000
0000000000T0000000000000000G00
0000TG0000GH000000SH0000000000
0000S000S00000GT000G0000000000
00000T00G0000S0S0000000000G000
0000000G00000T0000000000000000
