00g000S0S000000000M00000M0t000
00000t0000g00000000g0000000000
00000g00000g000000000S000S0000
S000tS0000000000000000g000000M
00000gg0000B0000000B00B0000t00
000t00000000000000000000000000
000000000000000000000g00000000
0g00000000000g0tS0000000000000
000S0t0g000000000000g0S0000000
00000000St0000000000000S000000
0000000Sg00g00000B0000000000B0
S0t0000000000SM000000000000g00
0000000000S00000g00000g00B0000
S000000S0g00gM00t000MM00000000
0000t0000000000000000000000000
000tg00S00000S0000000000000M00
000g0g00t000S0000000B0000S0000
00g0000g00000000t0000000000000
00g00000t00000000S00000g000000
000000000000000000000000t0000S
00000000t0S0000000000000g000S0
000000000000000000000t00000000
g000S000000000000S00M000000M00
0000t0S0g000000000000000000000
0000000g0000000000S0t000000000
00000t00000000000000g0S0000000
00000t000000000000S000000000g0
00000000ggS0000000000000000000
000000S0000000000g00S0MM000000
000g000000t00000000000000000S0
