0T000000000000S0G000
00G0G000000000S00000
0000000000000T000000
00T00G00000000000000
G0000000000S000000G0
000000000T000000G000
00000000000S0G00G00T
T000S00S0000000G0000
T0000000000000000000
T00000000000SS000C00
T000000000G000000000
G00000T000S0000000G0
000000000T0S0SC00000
0000S000000000000000
000T000G00G000000000
000S00000S00T0000000
0T000G00000000000000
0T0000000000000G0000
G000ST00000000000S00
0G0ST0000000000S00G0
