00G00S000S0G00000000
000000T00000GG000000
T0S0000000S0000000G0
00S000G0T0000000GS00
00000G0GS00000S00000
000000000GT000000S00
000T000000S0S0000000
00000000000000000000
0T0000000000G0000000
000GG0000000SS000000
0000000S00000T0G0000
0000T0000S0000G0S000
00000000T000G00G0000
G0S000000000000000GT
00GS00S0G00000000000
000000000ST000000000
T0000G0000G000000000
00S0T0G0S00000000000
0000000000000000T0S0
0000S00G000000000S00
