00000000S0T0000000000000S00000
0S00000000GG0000000T0000000S00
000G0000000000T00000000000000G
000T000000G00S0000000000000000
00000G00T0000S00000000000G0000
000T00000000000000S00000000S00
0000000G000000000T0000S000S000
000S0000000G00G00000H00T000000
000G00000000000S000G0000000H00
0000T000000G000000000000000000
000000000S0000000S0000000T0000
0000000000T0000000S000000G0000
00ST0000000G00000000G000000000
0000T0000000S000000000000000G0
0000T000000000G0S000000000G000
0T000G0000000000000000G0H000S0
0000G000000000S0000T0000000000
000T000000S00000S0000000000000
00000000000G000000000000000000
00S000S0C0000GT00000000000G00H
0000000G0GSTH00000000000000000
0S000000000S00000GGH000000C000
00G00000GH00000000000000T00000
00000SS00T00G000000GH000C00000
0000T0000G000000000G0000S00HS0
0T00S00SC000000000000000000000
000000000000000000000000000000
G0T00G000H0000000000000000S000
0000000S0S000000000000000000G0
0000T000000000000000000SS0000G
