0t000000000000S0g000S00000000M
000000t000000000000S0000S000M0
0000000000000S0t000000g0000g00
0000000000S00000000000t000S000
0000t0000S0000000S0000000M0000
0000000000t0g0000g0B00000000S0
0000000000St0000Sg00000000000g
000tS00000S0000g00000M0g000000
00000000t00S000000000000000000
00t0000SgSM00000000000000000gM
0g0000t00000000000000000000000
0gS000000000000000S000M000000g
t0000000000000000000g000S00000
000000S000000g0000000000000000
t00000000000S0000000S000000000
00000000t0S000000000000S000000
0000000g0000000000000S0t000000
0000g00g000S00S00000000M0000B0
t000S0000000000000000000000000
00g00000000tS00000000000000000
000t0000000000000S0S0000000M00
000000000000t000S000g00000S00M
S0g00000t0S000000000Mg0B000000
0gS0t000000SM00000g0000M00000M
g00000000g00000000000000BB0S00
0000S0S0000M00M0M00M0000000g00
000000000000000000000000000000
00000000S00000000000g000000000
00g00000g000000000B000t0000000
0t000g00000000000000000S0gB000
