T00000G0000S0G00000S000C000000
0S0000G00000000000000T0S00000C
00000T00000G0000000000GS000000
000000000G000S00ST000000G00000
0S0T0000000000G0000000000G0000
000000T00000000000G0G000000000
0000000000000000G0000000000000
G000000G0000000000000000000000
000S00G00000G00000000000S00000
00000000000000G00000000S00000S
00G0000000S0000000T00000000G00
000000000000SG000000T00000000S
0000T0000000000000S00000000000
000000SSG000000000000G00000000
G00G0000000000000000000000000H
00S00T000G000000000000G0S00000
0000G00T00G000S000000H00000H00
00000T000G00000S0000000G00S000
0G0T0000000G00000000000000S000
00000G0000000000S00GS0T0000C00
0000000000000000000000T000G000
0000000G0000000G00000000H00000
00T0000000S0000S000000G0000000
0S0000G0000000T0000000000S00C0
00S00S0TG0000GC00000000C000000
0000000G0000000000S00000S000C0
0000000000T00000G0S000G0000000
00000000T00000000000000000S000
0000000000GS00000000T0S0000000
00000000000000S000000G0000000T
