0000g00t00000000000000000S00S0
00000000t0000000g0000gB000000B
0000000000g0000S00000000000000
0g0000000000gS00t00000000S0000
0000St000000000000S000000000g0
00000g000S0000000000000000t000
00t0000000000g0000000000S000S0
0t0000000000000000000000000000
00gt000000000000000g0000000000
0000000000tg0000S00000000000gS
0S00g00t00000g0SM00000B0000000
000000000000000000g0000g000000
g0000000t000000000000g0S000000
00g000Sg0000t000000000000S0000
000gS0000000000000000000000000
00000000t000000S00000000g0000g
t0000000000000000SS00000000000
t00000000000000000000000000000
00g00S0t00S0000000000g00000000
00000000g0000S0000000000000000
0000g0g000000t00000B0000BBS000
000000t00000000S0000000S000000
0000g000000000t000000000000000
000gtS0S0000g000000BM0000M0000
0000000000000tg000000S00S00000
000S00000000000000000g00000000
000S0000000g000000000000t00000
000t00g00000000000000000000000
000t000000000000000S00000g00SM
00000000000000000000St0S0g0000
