S00000000000T0SG0000000000000C
000000000000T0000000000000S0S0
G00T00000000000000000000000000
0G000T0000S00000000000G0000000
T00000000000000G00000000000000
0000000G0TS00000000G0000S00000
000000000000000T0SG000000S0000
G000000000G00000S0000S00000000
0000000000000T0000000G00000000
T0000000000000S00000000G0G0000
S000000000000SC0000G0G0000000T
0000000000000000000000T000000S
0000000T00000000000S00000000S0
G00000000000000000000000000000
T0000000000000000S00000000S000
0000G00000000000G0S0000SC00000
00000S0000000000S0000C0000G000
T0000000000000000000000GS00000
000T0000000000000G000000G00000
000S00000000000000000G00S00000
000000000000000000000000000000
0000000T000000000000000SS00000
000000000T00000000000S00000S00
00S000T00000S0C000000000000G00
00T0S00000000000GS00GC0000H000
0000000T0000000S000000000G0000
G00S000000000S000C000000000000
G000000000000T00000000S0000000
000000G0S00G0SH000T00000000000
00S000T0000000000000000SG0GC00
