00000000000St00000g0g00B000000
00S0000000t00g0000000000000000
00000000000000S00t00000S00000g
0000S000000000000g000t00000000
00000S0000t000000000000g000000
0000000000000t0S00000000000000
00000g00000000000000S000000t00
0000000g0S00000000000000000000
0t00S0000000g00000000000000000
00S00000S00000000t000Mg0000000
000000000000000S0S0000000M0000
00000000S00000g00000000000000t
0000S0000g00000000S0000000g000
000000000t000000S0000000000000
000000S000000t0S00000000000000
00t0000000000000g00S000S000000
0000000S0000g000g00000t0000000
000000000000000000000SS0000000
0S00000g00000g000000000t0000S0
0000S000t0g0000000000000000000
0000S000g000000tg0000000000000
00g000000g0t000000000000000000
00000000g000t0g00S00000000B000
000S0000000S0000M00000000M0000
0000tS00000g0000S0000000Mg0B00
0g0g00000B00000000000000000000
0000000000000g0tgS0S0000000000
g000000000000000000000S0000000
0Sg00000S00t0000000000000000M0
0000000000000000g0000000000000
