T0000000G0GS00000000S000000H00
000000000000T000G0S00G0S000000
00S000S00000000000000000000000
000000000SS000000000G0CG0000T0
000000000000000000000000000S00
00000000000000000000000000000T
000G000000000S00G000H000S00000
0T00000000000000G0S00G000000S0
0000S0000000000G00000000000000
GT0000000000000G0000S0000H0000
000G000000T00000000S0G00000000
TS0000000000000S00000C00000000
000000000G0G0000000T000H000000
0S0G00GH000T000000000000000000
0S00000000000G0000S00000G00H00
00S00000000S000T00000000000000
000T0000000000000000000000000S
0000G0G0000000S0T000H0000000S0
00T0S000000000000000000000G000
00000S0000G0T00S00000000000000
S0000000000000S000C00000000000
0S0000000000000S000000000T0000
0000000T00S0G00000000000000000
0S0000000000G00SCG000000H00000
00000000000G00T00G00H000000000
00S0000SC00000000T000000000000
00000T00000000SG0S000000000000
0T000SG000000000000G000000000H
S000000000000S0000000000G00000
000000000000000000G00000000000
