000000000000000t000000000000g0
000000000000000000000000000000
000g00000000t0000000000g000000
0t000000g000g00000000000000000
tS00000000g0000000000000g0S0B0
00000000000S000000000g00000000
0t0000S00S0000g000000000000000
g00000000000000000000S00000g00
000000S000000000S0g00000000000
00000000000000000g00000000B000
00g000000000000000000000000000
000000000000t00S00000000000000
0g00000000S000000000000000g000
00000000000S000000000000000000
00000S000gS00000000000g0t00000
0000000000000000t0000000000000
00000000S0000g0000000000S00000
00000000g0000t00000000g0000S00
0S00000000g00000000t0000000000
0000000t00000000000S000000000S
000000t0g000S0g0000000B000SB00
0000000000000000000000g00t000g
0000S00000g000000000000000000t
0000000S0000000000g0000g0B0t00
S0000000SMg00M0000000000t000M0
00g0t0000000000000000000000000
00000000g000000000g00000000000
00000S000000000S00M0t00g00000M
g00000000000000000000000000S0g
0000000000000S0000000S0000000M
