0000S0g00t0gB0000000000000000B
g000g000000000000S000000000t0S
0000000t0000000000000S0000000g
0t000g00000000000000000000g000
0000000S000000000000t00000S000
S0000000S00M0M00000M00000Mg000
0000S000000000000t0000000000g0
000000000000t0000000000S000000
000S000t0000S0000000000g000g00
000t000000000000000000000S0000
000t000000000000000000S0000000
0000000000000000tg000000000000
0000000000000000S0000Sg00M00M0
S0000000000000000g0000000g0t00
t000g0000000000000000000000000
00S00S00000g000M00000000g000M0
00000000000t000000000g00000000
00g00000S0gS000000000t00000000
t0g000000000000000000g0S000000
00000000000000000t00000g000000
0000tS0g0000000g0000B000S00M00
000000g000t0Sg000000000000B000
0g00000SS000M000000000M000g000
0S00tS00M0M000000M000000000g00
00000g000000000000000000000000
000tg00S0000000000S00M0g000000
00000000000000000000S0000000g0
0t0000000000S00g0000000000000S
000SS000000000t000000000000000
000000000000000000S0000S000000
