00G0000SS000000000000000000000
00000000T0000000000000000S000S
000000G000000000000000S00G00B0
000000000T00000000000000000000
00G00000000000S00000ST00000000
G0000000000000000000GT00000000
00000000GS00000S0000G0000B0MT0
000000000000000000000000000000
00G000000000000000000000000000
0000000000000T00SG0000S0G0000B
00000S0S0000000000000M00G00000
000G000000S000000G0000T00S0000
0000000T00000000000G0000000000
00000G00000000000G0000000B000S
00000000000G0000000000G0000000
0000000000S00000000000000G0000
00G00000000000000T0000S0000000
00000000G0000S00000000000G0000
000000T000000000000G0000000000
00T00S00G00G00000000000000000S
000000000S00000000S0T000000000
000000000000000000T00000000000
000000000000000000000000000T00
0GG00000000000000000000S00S000
0000000000ST0000000G0000000000
00000000000G000G000000S0S000MM
SG00000000000S0T0000000G000000
00000T0000000000000000000G00S0
S000000000000000G00S0T000G0000
00G0S0000000T0000000000000S000
