00G00000000G00S00000000S000000
000000000G00G00000000000000000
S0000000G000000000000000000000
00000G0000000000000000000000S0
T000000S000000000000G000000000
0S0G0000T0S000M000000000000000
00T000000G000000000000G0000000
0000000T00000000000SG0G00000S0
00T000000G00000000000000G00000
000000000T00G00000000S0G000000
0000000000000S00000000000G0000
G0000G00000000000BT00000000000
000G00G0000B0000000000T00000S0
0000T00S0G000G0000000000000000
0000000S000000000T000G000G00B0
G000000G000000000000000B000000
00G00S000000000T00000000S00000
000GG000000000T0000000S00B0000
0000000000GG0T000000000000B000
0000000SG000000S0T00M00G0000M0
G0000G000000000000000000SB0000
00S0000G0000000S00000000000000
00000S000000T00000000000000000
00S000T000000000000000S0000000
0000000000000S000T000000000000
000T000000000000000G00G000B000
0000000T0G0000S000000000000000
000T000000G0000S00000000000000
0000000000000000G0000000SS0000
00000S0000GS0000G00000000M0000
