000000000000000S0S00
S000S0T0G000G0000000
00000000000000TS0000
0T00S0000000000S0000
0000000000T000S00000
0000SS000T000G000000
G000000000000S00000T
SS00T00GG00000000000
0000000000T000000GG0
0000000S000S00000GT0
T0000G000S0000000000
000000T00S000G00S000
000T00G0000000000000
T0000000000000000G00
0T00GS000S0000000000
0000000000G0000G00T0
0000S0000000G00000G0
000000000000T0000000
0S0S000000000000000T
G00000T00S0000S00000
