S00000G0000000000S000000000000
TS000000000000G0000000000S000G
00000000G000S00S00000000T00000
000000000T000000G000000000G00H
0T0000S0000000G000000000G00000
000000000T000000000000000000S0
000G0000S000000000000000000T0S
0TS000S0000000000C000000000000
G000T000000000000000000000000S
0T0000000000000000000000000000
000000000000T00000000000S0000S
00000T0000000000G0000000000000
0000G0000000000000000GT0000S00
000T000000000S00000G00000S00C0
0G000000S00000000SG00000C000C0
000000000000T00000000000000SG0
T000000000G00000G000000000S000
00G0T000000G00H0000000S0000000
GS0000000000000000S000000000C0
0000000000000000000SS000000000
00000000T00000000SG00G000S000H
0000S00000S00G000G00T00C000H0H
0000S0000000000000000000000000
000000000T000000000000S000000G
GT0000000000000000000000000000
0000S0GT000000000000G0000H0H00
00000G000000000000000000000000
0000G0S00T000S0000000000000000
T00000000000000000000000000000
0T0000000S00000000000000000GS0
