00000000000000T000000000000S00
0000000000000S0000000000G00000
0000000000000000000000000S0G0G
G000000000000000000G00000S0H00
0G00T000000000000000S000000S00
000000S0T00000000GG000000S000H
T00G000S0000S00000C00000000000
0S0S0000G000T000000000000C0C00
00SG00000000000000G00000000000
00G000000000G000000000000000S0
000000000000000GS0000T00S00G00
T0000000000000000G0000G0000000
T000000G00S0000000000000000000
00000G0G0000000H0S000000T00000
S00000000S000C0C0G000T0000000C
0S0000S0000000G000000000000000
00000000000000T0G0G00000000000
0GSG00000000000SH0000000000000
0000G00000000000T0000000SG0000
000000000000T000G0000000000000
00S0G0000S000G0000000000000HTH
000000000T000S000000000S000000
0000000000000000S0T00000000000
00T0S000000000S0000000000G0000
0000000G0G0000000H000H00000000
0000000000G000000S000T00000000
000000000000S0000G0000000000SC
00G0000000000000000000000S0000
0000T00000000000S00000000000GS
0000000000S000T00000000000S000
