0000g00g0000000000S000B0000t00
0000t000000000g0g0000000000000
0000000t00S0000000000000000000
0000000000000000g000g000000t00
0000000t0000000S000000000S00g0
0000000000000000g000000000000t
0000000g0000000000000000000000
00000000000000S0000S0000000000
0t00000000g0000000000000000000
00000000t000000S000S0000000000
00000000000t000000000000g00000
00t0g0000S000g0000B00000000000
000000000000S0g00000000000000g
0t0000S0S0000000g00M0000000000
00g000t00000000000g00000000000
0000St000000000S0M00000M00000M
00000000000t000000000S00000000
00000000t00000000000000000000g
0000t00000000000000S00000S0000
000S0000000S0000000M0t0gg00000
0000000000000000000000000000t0
S000000g00000000000000tg000000
0g00000S0000000000S00000000000
00S0000000gg0000t00B00S000000B
0g00S0000S000gM00t0B0000000000
000000t000g00000Sg000000000000
000000g000000t0000000000000000
00000000S000000000S00000000t00
0g00S00000000000000000000S0000
00S0000000St000M0M00g0000000Mg
