000t00000000000g00000000S0S000
0000g00000000t0000000000000000
00000000000000t000000S00000000
000000t0g00g000000000000000000
000000000000000000000S0S000t0M
0t0000Sg0000000S00000000000000
000000000t00S00000S00M00000000
00S00000t000000000000000000000
00000000000000000g000000gB0000
00000000000000000t00000g00S000
00tg000S0000000000S00000000000
000S00000000000000000S0000t0g0
00g00000t0000000S00000g0000000
00000000000g000000000t00000000
000t00000000000000000000000000
g0000t000000000000000000000000
0000000000t0000000000000000g00
0000000S00000000g0g00000000000
000000000t0000000S000000S00000
0000t0000000S0000g0S0M00000000
0t0000000000000000000000000000
00t00S000S00000000000000000000
g000000000g0000000000S0000B000
000000S0000000000000gS00000000
0000SS000000000t000M0000000000
0t000SSM00g0000000000000M00000
00000000t000000000000S00000Sg0
00g00000000000gtB0000000000B00
0000000t00000000000000000g0000
000000000000S0S0MM000000000000
