0T0000G00000000000000S00000000
0GS0000000G00000H0HS0H00000H00
00000SG00000000000T00000S000G0
00T00G000000000S00000000G000S0
00T00000G000S00000000000000000
G00000T000G000000000000H000000
000000GS000000000S000000000000
0000G00G00000T0000000S00000000
00000S00000000T000000000000000
T0000S000000000000000000000000
0000T000G000000000000G00000000
0000000000000000G0S00000T00000
00000000000000000S000000S00000
00T0000000000000000000S0000000
00000000000000000G0000000000T0
000000S000000000000T0000000000
0000S0000S0000G0000000G000C000
000000G0000000000000000000GS00
G000000000000T0000SS0000000000
T0000000000G000000000000000000
0000000000T0S00000S0000C0000C0
00000000000T00000000000S00000S
0000000G00ST00000000000G000000
000000S00000000S0000T000G00C00
00GG00T0000000S000000000000000
0ST00000000000000000000000G000
000000000T0000000G000000000000
0000G00SGT0000S0H000H0000HC000
0G0000000000G000T0000000000000
T00000000000000000000000000000
