00t00000S0000000S0000000M00000
000000000000000t000000g00S0000
g00000000S0t000S00000g00000000
0SS00g00M00M000000000000000000
000000gg00000000000t0000000000
000000000000g00g0S000000S000t0
000S000S00000000000M000g00000M
0S00000g00000000000000000000t0
000000000000000000000000t0000g
000t0000000S000g0g000000B00000
0S0gt0000000000S00000000000000
00000000000S0000000S0000000000
0S000g00000Sg0000000B00t00000B
0000000000000000000000t0000000
00t000000000000000000000000000
tg000000000S0000000000g00000B0
000000000t00000S000Sg000000000
00000SS0000000g000000t00000000
t000g0000000g00B00000000000000
0S0S000t0000M000000000000g0000
000000000000000000000000000000
00000S00g0000000000g0000000000
000SgS0000000000M00000t0000000
000000tg00000000000000g0000000
0000g0000000000000000000000000
S0S0M0000t000g0000g00000000BMB
0000000t000000S000000000000000
000000000000000000tS000g000g00
000000000000000000000S00000000
g0000000000000t00000000S000000
