0TG00GS0000S00000000
00000000S000G000T000
00T00000000000G00000
0G0000000000000000T0
00S00000G00000000000
T000000G000000G00000
00T00000000S00000000
0GS000T00100000000S0
0S000000000000000000
000000G0S00000000000
G00000G00000000000T0
0000T000G0000000G00S
00S00T00000000000000
T00G00G0000000000000
GSS000000G0000000000
00T00G000000G000S000
0T000000000G00000000
G0000SS0000G00000000
S0000000000000000000
0T0000000000000000S0
