00G0G000T000000000000000000000
0T0SS0000000000000000000000000
000000S0S00C000000000G00000000
0000000000T000000000000S000000
G00T00000000S0000S00C000000000
000000000T0000000000S000000000
0000000T00000S00000000000G0G00
0SG00000000000G0000000S0000C00
000T00000000000S000000000000G0
0ST00G0G00000000000000000000H0
G00000G000000000000000000S0000
0000000000000000GT000G0S0H0000
000TG0000000000000S000G0000000
0T0000000000000S000000000000G0
000000S0000000S0000000000000T0
0000G000000S0000000G0000S00000
0G00T000000S0000S000CG0000000H
00000T00000000S00G000000000000
0000T0S00000000000000SC0000G00
0T00G0000G000000S0000000000000
000000000000T0000000000000G0G0
0T000000S000000000000000000000
00000G00000TS0GS0000000000000C
0TS000000G0000000000000000G000
G0000T00000S00S0000G00000H0000
00000000G000G00000000H00000000
00000000000000000S00000000S000
0000G0000G00000000000000000000
S000000000T00000S00GC00000G0H0
000000000T000000000000S0000000
