0TS000G0000000000G00
0T00000000S000000000
00GSG00T000000000000
0G0000000000S0000000
T0000S000000G0000000
000000SST00000000000
0G0SS0000000G0000000
00000S0T000000G000G0
0T00S000S00000000000
000S00TS000000000000
000S0T00000000000000
00TG0000000000000000
G00000ST00000000S000
00ST0000S00000000000
00S00000000000000000
0G0000G000SS00T00000
000000ST000000S00000
T0G000000S0000000000
0000000T0000000S0000
000G0000000000T00S00
