00000G000G00000TS000
0000000000S000SC0000
000000S000000T000SG0
0000000000000000S000
0G0000G0000000000000
00S00T0000000G000S00
000000000000T0000000
ST0000G0000000000000
0G000000T0000G000000
G0000T000000000S000S
ST00G0000000000SC00G
000S0G000G0000000000
000000T0000000000000
00000000000G00000000
000000T000S00000000G
0G0000SG000000000000
00T000000000000000S0
0000000000T00000GS00
000T000000SS00000000
G0G0000000000000S000
