S0000000G00000000000S0000C0000
000000000000000000T000000G0000
S0SC00T0000000G000000000000000
000000000G00000S0G0000T00000H0
0T0000S00SGGC00000000000000000
000G00S00000000000G000000T0000
000000000000000G00000000000000
00T000000S00000000000S00000000
GGS00T0000H0000000000000000000
000000S0000000000000000TS000C0
00G0G00000000000S000H000000000
G000000T0000S00000000000000000
00000000000000000000000000000G
0000G000000000000000000000TG00
G00000000000G0T00000000HS00000
T0GS000000000000000000000GH000
000G00000000000000G0T0000000S0
00T00000000000G000000000000000
0000T00000000S0000G00000000000
0T000S0000S00000G0000000000000
00000G0T000000000000000G00H000
00000000000000000000000000G000
000000000S0000000S0000000GT000
0000000G0TG0000000000000000000
0G0T00000G00H00000000000000000
00000T00000S00S000000000000000
0000000G0S00000000S0000G0000H0
00000S00000000000000S00T000000
0000T000000000000S00000000000S
00000000000000000G00T000000000
