0000S0000000000000000000GT0000
000000000000000000GS00S000C000
0T000G00000S000000000000000000
000000000000000000000S00000000
00000000S000T00G000000000G0000
T00G000000000000000G0000000000
0000S00S0G00000000T00000000000
0T0S0000000G00G000000000S00000
0000000S000000T00S000000000000
0000G0000T000000000000000S0000
0000TG00000000000000SG00000000
00000000T000000G00000S0G000000
00000G000000000000000ST000000S
000000T00G00000000S00000000000
000T0G000000000000000000000000
00000TG0000S000000000000000000
000T000000000000000000000000S0
G00000000000000T0000000000G000
00S00000SC00000G000CC0C00000T0
G0000000000G00000S000T00000H00
00T00000000000000G0000G000000H
0S0000000000000000000000000000
00000S000000000ST00000C0000000
0000000000000000000000T000G000
00000000000000000S0S0000000C00
0000T00000000000000000G0000000
00000000T000000000000000000GGH
S00000000T00S00G000000000C0000
00000T000000000000000000G00000
GG0000000000S000000000H0000000
