00g000g00000t000000000B000000B
0t0000000000000000000S000000Sg
000t0gg0B00B0000000000000S0000
t0S00S00000000M000000000000000
00000000000gS00S00000000000000
000000000000t0000000g0000000g0
00tg000000g0000000000000000000
000000000000000000t0S000S00000
00t00000000g000g0000S000000000
000000000St0000000000000000000
0t00000000000000000000g0000000
g0S0000000t0000000000000000000
00t00000000000000000000000g0g0
00g00000tg0000000000000000000S
0000000000000t000g000000000000
0000S00000t00S000000000000M000
000000t0000000SSg000M000000000
0000000000000000t00000S000S000
0000000t00000000000g0000000000
00Sg0S00000000g0t00000000M0B00
000t00000000S000S0g0000M000000
000gg0000000000000000000000000
00t000S000000000000S0000000000
0g00000g000000S00t00B000B00000
g000000g0000000S00000000000000
0g0000000g00000000000000000t00
0Sg000S0000g00000B00000B000000
00000000g000000t00000000000000
S000S0000000000g00000g00000t00
000000tSS000000000000000000M00
