0000000T00000000000000G0000000
000000000000T000S00G0000000000
0G000000000000000000S00000000T
00T0000S000000000000000G000000
000000000000000000000T00000000
00000000000G0000000000000S0000
0000000S0000000000000T00000S0G
T000000000000000G000000000000S
000000GS000000000G000000T00000
0T0000S00000000000S00000G00G00
00000000000000000000000000SG00
0000T0G00000000000000000000000
00GT0000S0G000000H00000S000000
00000G00000000000G00000000000T
000T00G000000S0000000000000000
000S00000GG000000H0000000T0000
00000000S000000000000000000S0T
00T0000G000000G000000000000000
00G000000000000000S0S000C00000
G0000000T0000000000000G0000000
00000G000G0HT000000S0000000H00
000T0000000G000000000000000000
000000S0000T0G0000G0000S0000H0
000ST0000000000000000000000000
0000000000T00S0000G00000000000
G0S00000000000T000G00000000000
000000S000S0000000000T00000000
T000000S0000000000S000G0000000
0G0000000000000S00000000000000
000000000S0000G00000000G000000
