0g0000000000000000000t000S0000
0000S00t00S00000000g0000000000
00g00t000000000000000000000000
0g000000S0t000000g000000000000
t000000g0S0g000BS00000B000B000
t000000000000000000000S0000000
0000000000S0g00000000g00B00000
S000g000000t0000g000000B0B0000
g00000000000S0000g00S0M0BB0M00
00t000000000000000S00000000S00
00000000t000000000000000000000
000g0000t0000S00000000000000S0
00000g0000S0000S00000000M00tg0
0g000000t00000000000S0000000Sg
000000000t00000g00000000000000
Sg00g0000000B00000000000S0000B
0000t00S0g00000000Sg0000000000
00000000t000000g00000000000g00
Sg000t000000000g000000000B0000
000000000000000000000000000000
0000000000000000000000000S0000
000000t0g000000000000000000000
00S000000SM0000000000MM0t00000
t0000g000S00g00000000000000000
0S0000S0000000M0000M000tg00000
000000gtS00000000000000000S000
0000000S000000000t0000000000S0
00000000000000g0S00000gt000000
0000000000000000000g0000000000
0000S000000000g000000g0B000000
