00S00000000G000G00H00000000000
G000000G0000000000000000000000
00G0000000000000000S0000000000
0000G0000000000000SS0GH0000000
00000000S0000000000000000T0000
0000000T00000000000000G0000000
000000000G00000000S00000000000
00000000SGT0000000S00000000G00
000000T00G00000SG00000000000H0
0G0000T0000000G00000000H00000S
0G0T0000000000000000SS00000C00
0000000000000000G000000G0T0000
00T000000000000000000000000000
00000000000000G000000000000000
0000000000S000000T00000S000000
0000000000S0S00000000000000000
T0S00000000SG000C000000000000G
0000T000G00000000000000G000000
00S000S000000GCT000000G00H0000
000S0SG0C000G000T00000H0000000
0000G0000000000S0000000000000G
00000000T000000000000000GS0000
000000000000000T000S00S0000000
000000000S00000000000000000000
0000000000T0G0S0000000000000S0
00000000S00T00S00000000000C000
G00S0000000ST00000000C00000000
00S000G00000000S00000G0T000C00
0000000000T0000000000000000000
0000000S00000000000000000S0C00
