0000000000000000000000S0000000
000T00000S00000000000000000G0G
000000S0S0C0000T00000000000000
0000000000000000G00000T0000000
000G00000000S00ST0000000000000
000000000T000G0000G00000000000
00000000GS00000000000T000S0000
00S00000S0G000000T00C000000000
T0S000000000000000000000000000
00SG0000000S0000000G000C0000T0
00G000000S0000G00000T0000H0000
00G0ST000000000000000000S00000
000G00000T000000000G0000000000
0000000T00000000000G000000G000
00000T00000G000G00H00000000000
000G000000000T0000000000000000
0000000000000T0000G00000000000
000000000T00000S00G00000000000
G000T00G00H000000000S000000S00
G000000ST000000000000G00000000
0000000000G00000000000000T0000
000000000S000000T000000G000000
00G00000G00000H000000000000000
00G00000S00000000000000000000S
T0000000S000000000000000000000
00000000G00000000T000000000000
0G00000000S00G000000000000H0S0
000000S0000000000T000000000000
0000000G0000000000T00S00000000
000G0000S000000000000000000000
