0000T000000G00000S0000000G0000
00000000000000G000000T00G00000
TS0000000G00000000000S000000C0
0000TG00G0000000000000H0000000
G00000TS0S00000000000000000000
0G00S000000000T000000000000000
0T00000G0000000000000000000000
T00000000S000S000GG00000000000
000S000000000000000G0000000000
0000000000000T000000000G000000
S000T00S000000000000000000000G
0000000S00000T000000G000000000
000G0S0T00000G000S0000000000C0
0000000T0G00000000000000000000
0000G000000000000T00000000000G
00T000G000G000000000000000000S
0000000000000000S0T00S0G000000
0000000000T0000000000000000000
00000000000000000000000T000000
T00G0S00000000000000000S000GC0
00000000000000000G000000000000
0000S000000T000000SCG000000C00
00000S00S00000T000000C00000000
000000T00000000000000000000000
0000000000000000GT0000G000S000
00000000T0SS0000000000000GG000
00000G00T000000000S0000000S000
S00000S0T0000000C0000000000000
000000T000G00G00HS000000000000
0000000000S00000000000000S0000
