000g0000S000000000g00000000000
0000000000000000000S0000000000
000g000000t00S0000S0g0000M0000
00000t0g00000000000000000S0000
0000000S000000000000000S0t0000
000000g000g00000S0000t00000000
gt000S00000000000000S00000M000
00000000g0g0000000t00000S00000
g00000t00000gS000000B00S000M00
0S00S0t0000000M000000M0000000g
00000000000g00000g000BB000S000
00S00000000000000t000g00000000
00g0000S0t000g00S0000000000000
t0S000000g000000000000000S0000
0tg0S0000000000000000g00000000
000000tS000S00000g00M0000000MM
00g00t000000000000gB000000S0B0
000000S0000000000g0S000t000000
0000000S0000000000000000000000
g0000000000g00S000000000000000
00t00g0000000S000000000g00S0BB
0000000000000000g00000000000t0
0St0000000000g000000000000000S
00000000g00g000000B0B00000B000
000000S0g0000000000g0t000B0000
g000t00000000g00B00B000S000S00
00000000000000000000t00000gS00
0t0000000000S000000g0000S00M00
00t00S0000g0000000000000000000
t000Sg00000g000000000000000000
