000000g0000000000S00000000t000
0S00g00S00000M0000000000000M0g
0000000t0S000000000S00000gg00B
S00S00tg0000M000000000g000000M
00S00tS0000000000000000000000g
000S0000000000000000S00000000t
000000000t000S0000000000000000
0000000000000000000t0000S00000
0g000000g00000000000000B00S000
00t00S000g00S0000M000000000g00
gS00g000000SB0000000000M000000
0000000000000000000S0000000000
S00000g000000000000S000000M000
g00000000000t0g0000000B00000S0
000000g0000000St000000S0000000
000000000g00000000000000000t00
0000000000000000000000000g0000
00000S00000S000000000000t00000
00S000t00000000000000000000000
00000000000t0S0000000000000gg0
00S00g000000000000000000000000
0g00000000000000000000g0000000
00000g0g0B00000000000000000B00
00000000000Sg0000000000000t000
000000t000000S0000000000000000
00000g00000St000000000000000S0
00000S0000t0000g00g000000000B0
g0S000000000S0g00000000t00B000
0000000000000000000000000t0000
g0t0000000000000000SS000000000
