00000000000000000000000000000t
0000000S00000000000S0000000000
S00000000t0g000S00Mg00B00M00M0
0t000000000000000S00000000g000
t000gS000000000000000000000000
000000000000000t00000g0g000000
000000g0000g00000000000000000B
00000000tS0000000000000000000g
000000g00000000000000000000000
0g0000000000SS000000000g0000B0
0000000t00000S0g000g0000000000
000000t00000000000000000000g00
0000000g00000g0000000000000000
00g0000000000000g0000t00000000
00000S0000gt0000000g000000S000
0S0S0g00000t0000M0000000000000
00000000000000tg0000000000g000
000000000000t0000S00S0M0000000
000t00000000000000000000000g00
0000S0000000000000S00000000000
0000000000000SS0g0t0000M000000
S000S000000000t00M0000g000M000
0000g0000t0000000S000000g00000
00t000000000000000000000000000
t00000S000000000S000000000M000
00000St00g0000000000g000000000
00g0000000g00B0000000S0000000t
000S0g00S0000000000000M0000000
00000000S00gg00S00000000000000
00t0000000000000S0S0ggB000000M
