00000000000000000000000G00S000
00T000S00000000000G0000G000000
0000SG00000000000GT000000000S0
000GG000000000H000000000000S0S
00000000000000000S000000000000
0GT00000000000000000000G0000S0
0000000G0G0T00000000000H0000S0
0G000000G000000000000S0000000S
00G000000000000000000G0000000H
GS000S00C00000000GH00000000000
0000000000G00T0000S00000000000
00000G00000000G00000000S000000
000T000000000S0000000000000000
000T00000000S00000000G00000000
0000T000000S000G00S0C000000000
S00S000T00000G00000000C0000000
00T000000SGG000000000S000H0000
0000000000000S00000000000T0000
0000000S0G0000000S000GT000H000
0S0000S00C00G00000G00000000000
0000000S00000G0000G00000000000
000SG000000SC00000000T000000G0
000000STG00000S0000000000000C0
00T00S00G0G0000000S0000C000000
T00000000000000000000000000000
0000G0000000000T00000000000000
0000000000S0000000000000S0G000
000000000G00000000000000000T00
00000000000S000000000000000000
000G000000000000000000G00S00H0
