G000000T0G000000000000HS0S000C
000ST00000000000G000S000000000
00000000T000000S00000000000000
00T0000000000000000000G0000000
000T00000000000000000000000000
00000000G000000GT000000000000S
000000000000S000000S000000T000
000000G000000000T000000000000G
000000000S000T0000000000000000
00000G00T0000000000000S000000S
00000G0000S0G00000000H000000H0
000000000000000SS0000000000000
0T0GS0000000000000000000S0G000
0000T0000000000S00000000S00000
G0000000S0000000S00000GH0C0000
0000G000T000000000GS000000000S
0000000000000T000GS000S000000C
00G00S00T0000G0000000000S0000H
000000000GT000000G00000000S000
0000T000000000G00000000G000000
00SG000S0000000G00T00000000000
T0000000000000000000S0G0000000
G000000000000000000T0000000000
000000000S0000G00000000000000T
0000000T000000S0000000S0C00000
0SG0T00000000000G00S0C00000C00
000000G00000000000000G00000000
000SG000000S0G0000000000000000
00000000000000000G00T000000000
00T00G000G0000000000H000S0HS00
