00000000000S0000000t0000000000
0tS000000gg000000B000000000000
0S0S00000M00000000M0M0000M0000
0000g00000000000000000000000g0
00000SS00000000000000000000000
0000000000000000000000000SSM00
00000g0000t00000000000S0000000
000000000000000000000000000000
00000g0000000t00g00000S000B000
0t0000000000g0000000000000000S
000000000000t0000000000S000000
000000g000000000S0t00000000000
0Sg0000000t000S00000000000g000
0t00000000S0S000g00000000g0000
000S00000000t0S0000g00000gB000
0g0000000000000gB0000000B00000
00000g00000000g00000BtS0B00000
00gt000000S000000000000gS00000
000000000000g00000000SS000t000
0g00000000S000t0000000000g0000
gS00000S0000000000g0t0000B0000
000g00000000000000g00B000S00t0
00g00g0000000B0000000S00000000
00S00000000g00000000SM00000000
00000S00t000000000000000000000
00000000000S0S000000M000000000
0t000S000000000000000000000000
000000g00000g0000S0000000t0000
00g00g0000000000000000000000B0
00g00gt00000000000S00000000000
