000000000S0g0000000t000S000000
000gS00SMMt0000000000000000000
00000000000g0t00g00B000000B000
00000000000000000S000000St0000
000000000000g000g000000000S00t
0000g0000Sg000000000B000000000
gt0000S0000000g0S000B0000MB000
0000g00S0000000000000000000000
00000000000000SS0000000000000M
0000000000000t0000000000000000
000g000000t000000000000000g000
0000tg00000000000S00000g00000S
000000000000000000000000000000
000000000000S0000000000t000000
00S0000t0000000000000000000000
00tgg0000B00000000000000000000
0t0000g0000000000000g0000S0000
000000t0000000000000000S000000
00t00000S0000S0000000000000000
000000S000000000000000g000000t
0000000g0S0t0S00000000000g0000
000g0000000000g00000B000BB00B0
0000000g0000S0g00B0S0t0B000000
g0t000000S000000000000S0000000
000000000000t000000000S0S00000
00000g00000000000S000000000000
00000000g000t00000000000000000
0000000000S000000SMM0000000000
00000000t0000000000000S0000000
0gg0000000t00000B0000000000000
