000000000000000000000T000SG000
G0000T0000000G0B00000000000000
00G000000000000000000000S00000
000000000000000000000000000000
00000000000GG000000STS00000000
0000000000T0000000000000000000
000G0000000000000G0000B000T0S0
G00000000G00000000S000000000T0
000000000GT000000G00000000S00B
00S0000000G0S00000GM0000T00000
00000SS000000000G00000000G0000
0000000SS0000M00000000G0000M00
00S0T0000SM00G0000000000M00000
S000G000000G000000SMT000000000
000000000000000000T0000000S000
00G00000ST00000000G0000S0000B0
000000S000000000000000000G000T
000SST0000000000G0000000000000
00000000000000000G0000000T0000
000000S000000TG0G00S00000M0000
00000000G000000000S00SG0000000
000000000000000000000000000000
0000000000T0000000000S00000000
0000000000T0000000000000000000
0000S00000000S0000G0000000000M
000000S0000000TS00000000000000
000000000000G000G00000B000000T
00G0000000000000000000000G0B00
0GG000000S0000000B000S00000M00
000T00000000G0000000000G000000
