0000000000000g0SS00000000g0000
00000000000000000g00000000S000
000000t0g0000000000S0S00000000
00000000000000000000000000gg00
00000000t00000000000g000000000
000000000000000S00000g00000000
g000000gS000000000B0000000000S
S00000000gg0000t00000S00M00000
000000g00000000000000000000000
00000000Sg000000000000S0000t00
000000000000000gS0000000t00000
g000g0SS00000000t000000000000B
00g000000000000S000t00000gS000
0000000000t0000000000000000000
000000000000t00S000S00M0000000
0g0t00000g0B000000000000000000
000000t00S0000g0000g0000000B00
0000000S0000S00000t00000000000
0g00g000000000000B000000000000
000t000000000000000000000000S0
00000S0S0g0g0tB000B00000000000
000S00000g00S000M0000000000000
0g00000000000g0000000000tS0000
t00000g00g0BS00B00000000000000
0000000g00S00000S0000000000000
000g0000000t000000000000000000
00000S0000000000000000tS000000
0000000000000g0000000tg0000S00
000S000000t0000g0000000000g000
00g0S0000t0g000000B0S00BB00000
