S0000000000000000000000000g000
0000000000000St000000000000000
00000g0000000000000g000000t000
0000000000000000000000S0S00000
0S00000000Sg00t000000000000000
g000g00000000000000000t0000000
000000000000000S0gt00000000000
000000000000000Sg00S000000M000
0gS0gS000B000000M000B0000000B0
00000000g0000000000000000t0000
S000t00000000000g000S00000000M
0S00gS00000000M000000000000000
0000t00000S00000000000000S0000
000000000000t00S000000000000g0
000000S000000000000g000t000000
00gg00000S0t00B00S000000000000
0000000000g00000000000000SgS00
000000t00000000gg0000000000000
000000g0S00t000S0g00B00000M0M0
0000000g0g0000S00B000000000000
00000000000tSg0000000000000000
00000g000S0g000000000B0t000B00
0000g000g0000000B0B00000000000
0g00000000tg000000000000000000
0000000g00000000g0000S0S00t000
00000000000000000g0S000tg00000
000S0S00000M000t0000000000M000
0000gt000000000000000000000000
g000St00000000g00S000000000000
000000000000000000000000000000
