00G000000000000000000T0000S000
00000000G000S0000000S00000G000
000000000S000G00000000000G0000
0S00GG000000000000H00000000000
G00000G0T000000H00000000H00000
0000000000000G0000000S0T00G000
0T00000G00000000GHHS0000000000
00000000000000000000000G000000
000000T000S000000S000000000000
000000000000000000000000S00000
000G000S000000000000000000000T
T00S000G000000000000000G000000
0000000G0000000000000000000000
0G0000000000000000000000G0TS0S
00000000T000000G00000000000000
0000T0000000000S0000000000G000
000T00S00000000G00000000000000
00G00000S000S0000000T000C00000
000000000G00000000000000S00000
000000000000000000000000000S00
000000S0S0000G00T0000000G00000
000000S0T000S000000G0000000000
000000G0000G00000000000000S000
0000000S00000S00000000000T0000
0TS00G00S000000000G0CH00000000
T000000S00000000000S0000000000
00000T0000000000000000GS000SC0
00T000000G00000000000000000000
0000000000T000000000000G000000
0000000000000000000TS000000000
