T00000S000000000000000G0000000
000000000T00G00000000000000000
0000S00000S000000000T000000000
00000000G0T00G00000000B00000S0
000000000000000000000000TS0000
000000000000G0000GB0B0TB000000
00000T00G00000000000S00000G000
000000000000000G0000TG0000000B
000G0000000T000000000000000000
00000S000000S00G0000000000000G
00000S00T0000S00000000M0000M0G
00S00G000000G00000T00000B00000
0000000T000000000G0G0000000000
0000000G0000000T00000000000000
0S00000000000T0000000000000000
00000000S0000G000000000S00000G
000000S00G00000000000S00000000
000000G0000S000000S0000000000G
0000000G0000S000000ST000000000
000000000000000T00S00000000000
G00000000000S00000000000000000
T0G000000000000000000G00000000
000000000000000000000000000000
G000000T000000000000G000000000
00000000000000GT00000000000000
0T0000000000000S000000S0000000
G000000S0000G0000T000000000000
000000000G0000000000T000000000
000G00000T00S00S00000000000000
000T00000000000000000G00000000
