00G000000000000G000000000S0000
0000T000S000000000000000000000
0T0000000000000S000000000S0C00
00T000SG000S00000000000G000000
00T0000000000000000000S00G0000
000S00000T0G00000000G000000000
00000000000000000S000000G0G000
00000000000000000000S000000000
000000000000000000000000000000
00000000000T000SG000000000G000
000000000000000G000T00S0000000
0000000S000G0000000000G00H0000
0G000000000SS0G0000000CCH000H0
00000T000000SG0000S0G0000C0000
00000S0000S000C00000C000000000
00000000000000000000000GG00000
00000T00G00S000G000H0000H00000
G0000G000HT0000S000000000H0000
00000S0S00000G00CT000000000000
0000000S000000000000T000000000
00G000000000000000000000000000
00000000000000G00000S000000000
00G00000000S000000000G0H000000
00000G000000000000000000000000
G0000000000000T000000000000000
0000000000000000000000000000T0
000000S0000000000000TS00000000
T0G000000000G0000000S000S00000
0000T0000000000000000000000000
00000000S00G000000000000000000
