00T00SG00000000000000S00000000
00000SG0SGT0C00000000000000000
0G00000000000000000000000000T0
000000000G00000000000000000G00
0000000S0S00000000000000C000G0
0TG000000G0H000000000000000000
000000000000T00000000000000000
0000000000S00000000000000T00GG
0000000000G00G0000000000000000
0S0G00T000000000G0000000000H00
T000000000000S000G0000000000G0
00000G0000000S0000T000SG000000
0G0000000G0000000000000000000H
0000000000S0000000000T00000000
T00000G000000000000000S000S000
000T00000000000000000000000000
00000000000000000000000000S00G
0G00000T00000000000000S0000000
0000G0000T0000000G000000000000
00000T00000S000S000G00C0000000
00000000S0000S0000T00000000000
000000T00000G00G00000000000000
0G0T00000000000000GH0000000000
000000S000000000T00000S0000000
00T00000000000000000S0S0000000
GSSG00000000T00000000000H00000
000S0S00T00G000000000000000C00
0GGH0S0000000000T0000000000000
0000000000000000000G00000S0000
T00000000000000000000000000000
