000000T0000S000000000000000000
000T00G000000000000000G0000000
00000G000T00000000000000000000
00000000G00000G000000S00000000
0G0000000000000000G00000000000
00S000000000000000T0000G000000
0G00T0000000000000000000000G00
0000000000STG00S00000G0000C00H
00S000000000000000000000000T00
00000G000000000000000G00H0ST00
0000S0000T000000G0000000000000
000000000000000000000000000000
T0000000000000000000000000000S
000GS00000T000000000GH00000000
000000T000SSC0000000C00G000000
00000S0000T00000000G0S00000000
000T00000000000000S000000000S0
0SG000000000S00T00000000000000
0G0000000000000000000S000G0HS0
000S00000000000G0000T000000000
00000S00S0000G000000000CC00T00
000000000T00000000000000000000
0000000000000G000000G0H0000000
000S0TG0G000000000000S00000000
0G0G0000000H0000000S0000H00000
00000000T00000000S000000000000
000G000000S00000000S000000C000
000G000S0000G00000T0S000000000
000T00000S0000000000000000S000
0000000000G000000000000000G0T0
