000000000000SS000000
0S00000S00000000G000
000GG000T00000000000
00T000000000S000000S
00000000000GT0000000
0000000GT00000000000
00000000000G000000TG
000G00000000000S0T00
00000000000TG00000S0
000GG0000S0SC0000T00
000G000GS000T000000S
000T000000G00000000G
0000T0000S000000S00C
00000000G0T000000S00
G00000G0000000000000
000S0T000000G0000000
0000000S00000G00GT00
000S000000G0000000G0
0000S0G00G0S000000T0
GT0G00000000SS0000C0
