S0000g000000t000S0000000000000
0Sg00000S00g0000BM000000M00000
00000000g0000S00g00t0000B00000
0g0000t00S0000000000000S0000M0
S000000000t000000000000000S000
t00000000g0000S000g00B0S000000
00000000000000000000S000000000
00000000000000000000000ggS0000
000g00000g0t000S000B0000000000
00g0000000000000000000S00g0B00
00t00000000S000g00000000000000
00000000000000000000t000000000
00000000S0S0000t000g0000000000
00S0g00S0M0g00000tM00000000M00
0t0S0000S0000000M0000000000000
000g00g00B0B00t00S000000S00000
00000000000000000000t0S0000000
0g00000000000000g0000000t00000
000000000000000000000t00000000
t00000000000000000000g00S00000
0000000t000g000000000000000000
t000000S000000000S0000M0000000
00000g000000S00S00000000000000
g00000000000t00000000000S00000
SS0g0000000000Mt000g00000B00B0
00000000000000t000000000000000
0000000000000t0000SS0M0000g000
00000S0000t000000g000000000000
0000t0g00000000000000000000gS0
000000000000000Sg00000000t0000
