0TS00000000000000000G000000S00
0000000000000GS0G00T0000000000
000S000000000000S0000000000000
0000G0GTS0000SC00CC000C00000C0
0000000000000S0000000000000S0T
000000000000000000000T000S0S00
G000000000000000S00T000000S000
0000000000000S0G00000000000000
0000000000T0000000000000000000
00S00G0000G000S00C0000C0000000
000GT0S0000000000S000000000000
0000000T000S00G000000000000000
000GS0T0000000000GS00000000000
000000000000G00000000000000000
0000T00000000G0000000000000000
00000G0000G00000000000S0000000
0S0G00000S00000000000000000000
000000SG000000G0000000000T0000
00000000T000000000000000000000
0000000S000000000000S000000000
0000T000G0G00H0000000000000000
0000000S0T000G0000000000000000
0000000G0GS00000THH00000000000
0000000000T0000000000000000S00
0000000GT000000000000000000000
000000T000000000000S0000000000
00000000000000G0G0S0000000S0C0
0000G0000000000000000000000000
00T0000000G0000000000G000S0000
0000000000000000SG0000000T0000
