0000000000000g0000000000t0S000
00000000000000t00g0000000000g0
00000g0000g0000000000000000000
0g00g000000000000S000000000000
000000000S0000000S0M000000000t
0000000000S0000S000000000t00g0
t0000000000000S000000000000000
00000000t000g00000000000000S00
t00000S000000000000000gS000000
0000000000000g0000000000000000
000000000S00000t00000000000000
0000000000g000000S000000000000
0S00000000000000g0000t00g00000
0000000t00000S0000000000000000
0000g000SS000000000gM000M000t0
0000000000t0000S00000g0000000S
S0000g0000S00000M000000000M000
00000000000S000000000t0000g000
t00000000000000000S0000S000M00
0000000000g0t00000000000000g00
gS000000g0000000S0M00000000000
0t00000000000000000S000000S000
00000000000000S00t0000000g0000
t00000000000000S00000000000S00
t0000000SS00000000000000000000
000000000000000t000000000000S0
000000000000t000S00g0000000000
S0000tS0000000g000000000000g00
t00gg00S000000000SB0M00000M0B0
000000t00000000000000000000000
