0000000T0000000GS000
0000G0G00S0000000000
000000G0000000000000
000S00000T000G00000G
0000000T000G0S00S000
S0000G0000G000000000
00GS00G0000000000000
000000000G0G00000000
00T000G0S00000000000
ST000000000000000000
0000G0G0000000000000
00G0S00000T00G000000
0T0000000000000S0000
000S0000000000S00000
00T000G00000000G0S00
000000000000G00T0000
0000T0000000000000G0
000G00000G0T00000000
0G000000S0000SC00000
00S00000000S0000T000
