00000S000000000S0000T0G0000000
0000T0000S0000000S000000000000
0000000000000000T00S0000000000
0G000G000000000S0B00000B0000B0
S00000S0000G0G000000000T000000
G0T0000000000000000000000000S0
000000000G000G00S0000000000000
000000000T00000000000000000000
00000000G000S000S000G000000B00
0000TG000000S00000000G00000000
G0000000000000000S0000GT000000
0000T000000000G000S000000G0000
G00000000000000000000000000000
0G0000000000G000B00000S000000S
0000S00000T00000S0000000000000
000T000G0000000G00000000000000
00G0000000000000000S0000000000
000T00000000000000000S0SGM0000
SST000000000M0000000G0000G00M0
0000000000SG00000S00000T000000
000T000G000000000000000S00G000
0000S0000000ST000000000000M000
0000000000000000000ST000S00000
000000G0S0000000000000GS000000
G00T0000000000GS000000B0000B00
S000000000T000000000S000000000
000000SS0M0T000000000000000000
0000T000000000S000000000000000
0000000G0G00S000000000000B0000
000000S00000G0G0000000000T0000
