000000000000000000S0G0000000S0
TS0000000000000000000000000000
T00G0G0000000000H000000000000S
S000000000S000C000000000T00000
G000G00000000SH00000000000000T
00000S0000GGT00000000000000000
0T00000000000G0000S00000G00000
000G00T000000G0000H000000000S0
0G0000000G00000000000T00000000
00G00000000000000000000S00S0G0
GG00000H00S00T000000000000S00C
0S00S0CT0000000000000G000C0000
000000000000S0G000000G00000000
0000000T000000000000000000G0G0
G00S000S0G00000000000000000000
00000T000S0000000000000000G000
0000G00S000000S000000000000G00
00000000SG000000000000S0000TG0
0000S000000000000000000T000000
000000T0S00000000000000G0G0000
00S00TG00000000G00000000000000
0000ST00S000000000G0000000C000
00000000S00000000000000000000G
00T000G000000S00000000000G0000
000G0000SGH00SC00000000T000000
000000000000S000000SC000000000
GT00S00000000000G0000000000S00
0000G00000000000000T0000000000
00000G0S0G000000000000000000S0
0000000G0000S0000000S00000000T
