0000000G0000G000000T0000000000
T000000G00000G00000000000000S0
000000000000S00000000000000000
0000T0000G0000000G000000H00000
0000000000T00000000G00000000S0
0G00T00S00000000000000G000H000
0000000000000G000000000000G000
00000000000000000000T000000000
00000000S00T00G0G0000000S00000
00000S00S00000000T0000C00GC000
00000T00000000GG00000000000000
000000000T00000000000000000000
0000000T0000000000000000000000
00000000000T000000000000000000
000T0000000S0000G000GH000SC000
000GT00000S000000S000000000000
0000000000T00000000G00000G0000
S0000000000000S000000T0000000C
0S00000000000S0000000000000000
000T000S0000000000000000000000
00SS0G000000000G0T000000000000
S00T00000000G0G000000000000000
T000000G0G00000000000000000000
00G00000000000000G00T000000000
000000T0G000000000000000S00000
T00000000000000000000000000000
00000000000000000000000000T000
000GS000000000000T0000G0000000
000S000S000000000000000000G000
00000000000G00S00000000S0000G0
