S000T0000000000000S000000C00G0
000000000000000S000000T0000S00
00S000000G0SG00000000000H00H00
000000000G0000000000000T000S00
00S0000000000000TSC0000000000C
00000000000000000G000S0000G00H
0000000000TS000G0000G0000000SC
00000000000000000G0T0000000000
TS0000000000000000000000000000
00S0000G00S000G00000T00C0000C0
0000000SS00000000T0C0000C00000
0000000000T00000000000000S0000
00000000000G0000S000000000T000
000G00G0000T00S000000S00000000
S0000000T000000000000000000000
0000000000000G00000T000000000S
000000000000000T00000000000000
0000000ST000000000000000000000
000000000TS0000000000000000000
00000000S000000G0S000000000C00
00000000000TS00000000000000000
0000S00000000000G0000000000000
000T00S0000S000000000000000GC0
0G00000000000S00000000000G0000
0000000000000G0000TG0000000000
0000000S00G00000000T00000S0000
T00000000000SS000GGH0000H00000
S00000000000000S0000GC0C000000
S00T00000S00C00000000G000000C0
0S0000000000000G0G000000000000
