000000G0TG000000S000000S000000
000SG000000G0000000000S00000C0
000T00000S0000S000G0G000000000
00000000000G0000S0000000G00000
00000T0000G000000000S000000000
0000000G00000000000G0000S00000
0T0000000000000000000000000000
000000000T000G0000000000000000
000T000000000S00000S0000000000
000000000000S00GG0S00H00000000
0S0000T0S000G000C0000000000000
00000G0000S0000000S00T000C0000
T0000S0G0S00000G00000000000000
000000000G0G000000000000000000
0000GSTS00000000000000000G0000
000G000000G00SH000T00000S00C00
000000000000000G00S000G0000000
00000000T00G000000000000000000
00G00000G00T000H00000000000000
00000T000000000000000000000000
GS00000S0C0G000000000000000000
0S0T000000G0000000000000000000
GT0G000000000H0000000000000000
00000G000000000000S000G0000000
0000GG0000S000000T0000000H0000
00T0G0S0G0H000000SC00000000000
000000T0S00S00000000C0000G0000
000000000000S000G0S00000000000
00G0000GT000H000000S0000000S00
000000000000000T00000S00000000
