G00000G000S0T000000000000000S0
000000S00G0000S0G0C000H0000000
0S0000000000000000000000000000
00000000000G00S00000000S00T000
000S0000000G000S00C000000000G0
0000T000000000000000000G000000
00000000T000000000000000000000
0SSC000000000000000000000T0000
0000000000000000000000T0G00000
000G000G0H000S0000000000000000
0G00000S0000000000000000000000
S00000000GG0000T0S00H000000000
0000000000G0000000TG0H00000000
00GT000000000000000000G0H00000
0000000000000G00T00000S0S00G0H
000000000000000000SS0000000000
0000G0000S000000T00000000GH000
000000000000000000S00000000000
000G00000T00G0000000H000000000
T0000000000000G0000000000S0000
000T0000000000000000000000SG0G
T000000S000000G0S0000000000000
000000000000000000000T000G0000
0000000000G000000000000000ST00
000G000G0H00S0000000S00T000000
00000000T000G00000000S0G000000
0000S000000000T00000000S000000
0000000000G0G0000000S000H00000
S000S0000T000000000000000000C0
00000000T00000000G00S00S00000G
