ST00G0000000000000G00000000H00
0S0S000T0000000000000000000000
0000G000000000000G0000000000TH
00000000000S0000000TG000000000
000SS00C0T00C00000C0GC0000000C
0000G0000000000000000000G000T0
0S0000000000000G0000000000000S
S0000GT00G00000000000000000000
00000000000T000000000000000000
000T00G000000S0000000S0C000000
000000000T000000000S0000G00000
0000000000000000000000SG000000
00T0000G0000G00000S00000000000
00000000T0S00000000G0000S00G0H
T00000000000000000S00S0000G000
00S0000G00000000000G0000000000
000SS00T0000000000000G000000G0
0SG00000000000T0000000S00G0000
0S00000ST000000G00000000000000
000000S0T00S000000000000G00000
00000000S00S0000000000C0T00C00
0000000000000SGT00000000000G00
0000000000S00000000S0G0000000G
0G0S0000G0000000000SCH00T0000H
00000000000G00000000GS0000T000
000000S0G000G0H0000000H0000000
0000000G000000000000T000000000
00S0000000000S0000T0G000000000
00000000000T0000S0000000000000
00000000000G00000000G00000000T
