00000S0000T00000000000000S0000
0000G0G0000T00HS0000HS00000000
0000000000000T0000G00000000000
000000000G000000000000000000T0
0T00000000S0000G00000000000000
00000000000000000G0S00S0T00000
00000GS000S00000C0TC000000000G
000000G00000S000G00H000000S000
0000G00TG00000000S000000000000
0000000G0000000000000000G00000
000000000000000G00000S00000TS0
00000000T0G0000000000000000000
T00000000000S0000000G000000000
00000000000000T0000G0000000S00
0000000000000000000T00S0000000
0000000S00000T0000G000S0CC0000
0000000000000T00000000G0G00000
00000000T0000000000000000G000S
0G000000T000000000000000000S00
0000T00000G0000000S00000000000
0000000T0000000G000G0S00000000
G00000000G000000000000S0000000
00000000S0000000000000000000T0
0000000000000S0000S00000000000
000000S00000000000000000T00000
0000G0000000G000S0000000000000
0000000000000GG00000000000000T
000000000S00000000000000GG00H0
000S00000T0G0000000000000000S0
00000S0000000000000000000000G0
