000000000S000S000000
0TS000G000000G000000
T0S0GG00000000000000
000S0G00000TG0S0000C
SG0G000S0000C0000000
00G0000000000T000000
S00000T00G000000G000
000000T000G00000G000
0T000000000000000GS0
00000S000G00000G0000
0S0G0SG000000T000000
0S0S000C000000G00000
00000000000000000000
0G00G00S00000S000C00
00G0T0G0000S00000000
000000000000000000G0
000G00T0000000000000
0000T00000S0000G0000
0000G000000000000000
0000000G00S00S0T0000
