0000000000000T0000S000000000S0
00000000000T000G00000000000000
SS00000T000000000000000000G00G
SS0G0G000C0T000H00000000000000
0000000000G00G000T000000000000
0000T00000000000S0000000000000
S00000S0GG000H00C0T00000000000
00000000T0000G0000G00000000000
00000T00000000000000S000000000
000000000000000000G000T0G00000
00000000000000G0000000G00H000T
T000000S0000000000000000000000
000000000T00G00000S00000000000
00G0000000S00S000000000000000T
000000000000000000T00000000000
S000000000000000S0000T0C000000
000000000000S0000000ST000000G0
G000000000000T00000000000G0000
0G00000000G0H00000000000000000
00S000000T0S0000C0000000000000
0000000S000000000000000000G000
00S000G00000000000000000000G00
000000000000000000000S0TG00000
S000S00C00000000G00000000000T0
00000000000000S0TS00G00G0C0000
0S000000000000S00000C000000000
00000000T000000G00G00000000000
0000000000S000000T00000S000000
00000000000000S0T0000000G00G00
00000T0000000000000000S0000000
