0000000S000000g000000tg0000000
0000000000g0000000000000t00000
0000000000000000S0000000000000
00000S000000000000S00000000000
t000S0g0g00000000000000B00S000
0000000000000000S0g000S0000g0t
0t000000000000000000S00000g000
00000g000000000000000000000000
00000000000g0000t0000000000000
0SS00000000000t000000000000000
000000000000S000000t0000g00000
0000000t0000000000000S000000S0
000g00000000000000SgS000000000
00S000g00000t00g00000000000000
00t000000000000000000S00000000
0000000000000t00S00000000000S0
00000000g00000t000000000000000
0000000000S0000000S000gg000000
0000S0000g00g000000St00B00M000
0000S000000000000g0t0000g00000
0000g0000t0000000000g0B0000000
0S0000000S00g00tMM000000000000
0S00t0000g0000000g0B0000000000
0000000000000g0000000000000g00
0000000S00t0S000000g00000000M0
00000t00000000000gg0BBB0000000
00000000t0000000000S0000000000
t00000000000000000000g0S00000S
0000000000000000t000000000g000
00000S0000000000000000000g0000
