000000TSG00000000000S00M0000M0
S0SG000T00000M00M0000000000000
00S0000G0000G0000S0B00000000M0
00000000000S000000000000000000
00000000G0000T000000000000000G
000000000G000000T0000000000000
000000S00000000000000000000000
00000G00T0G0000000000000000000
00S000000S00M0M0000000000M0000
S00000000S0000M000000G0M0G0000
000000T0000000000S000000000000
0000000S00000S00M0T00000000000
0S000S000000000000000000000000
000000T00000S000000000000S00M0
SG000T000S000MG000000000000000
000G0000SG0000000000000000000S
00000000000000T000000000000000
0000T000000GG00000000000000000
0S0G00000000000G000T0000000000
000000S00000000S00M000T0000G00
000000000T00000000000000000G00
00000G0000S0000000S000M0000000
0000000000000S0T00000000000GS0
0000000G00S0000000000000000ST0
000S00000000SMT0000M000M0MM000
00T000G000000000G000000000B000
G0000000T0000000000000000000G0
S00000T00000000000000000000000
00T00000000S000000000000G00000
00000000G0000ST000000G00000000
