000000S00000g0000000t00000S0g0
0SS000000000000t000000000M0000
000g0000t0g000000000000S00000S
000S0t0000000g0000000000000g00
t00g000000g000B000000000000000
00000g00t0000000000g0000000000
00000t00000000S000000000000000
000000000000000000S0S00t000000
000S0000g000000000000000S00g00
0000g0000000000000S0000t000000
000000S0000g00000S0000t0000000
0t00000g00S00000000000g0000000
000000S0S0000M0000000000000000
0000St0000000000000S000000000g
0g000S000000000000000000000gB0
000000t000S00000gg000000000S00
00000000000gg00000S00000000000
0000000S000000000000000g0S0g00
00000tg00000000000000000000000
00000S0000t00S00M0g00000000000
S0000000g00000000SM00M00g00000
00S000000000000000000000S00M00
t0000000000g000000000000000000
0000000000000000000000g00000St
0000000S0SM000M000000000000000
g000000St00000000S000000000000
Sg000000t0g0B00000000000000000
000000S000000000000000000g0000
0000000g000000000S000t00000g00
000g00S00t000g0B00000000000000
