000T00000000000000S000000000S0
0000G0S00S000000CGH0000000000C
0000000000000000000000T000000G
00G0000000S0000000000000000000
0S00S0000000000CC0000C00000000
000S00000T00000S00000000000000
000T00000000000000000000000000
STG000000000000000000000S00000
0000000000000000000000G0000000
0000000000000000000G0000000000
0G00000000S0000000000000S000G0
00000000S0000000000000000T0000
0000000G00T0000000S00000000G00
0000G000000000000000G000000000
00000T00S00000S00C00000000000C
0T00000G000000SS00000G00000000
T00000G00S0000000GH00000000000
0000000000TG00000000G000000000
00S0S0T000G00C000000000G000000
000000000000T0000000000S000000
000000G0000000000000000000000S
000000000000T000000000000G0000
00000000000000T00G0000000G0000
GT0000000000000S000G00000H0000
00000000000000T0G00SG000000000
S00S000000G00C000T00G000000000
00000S0T000SG00000000000CG0000
0S00000G0000000000G00000000H00
0T0000S0000G0000SC000000000000
000000SGS0G00000000T00000C0000
