000SS0000000000000000000000GG0
0T000000000000G000S000G00000H0
000S00G00000000000S00000000000
00G0000000000000S0000000000000
000000T00S0000000000S000000000
00000000000000000GG000000000H0
00G000T000000G0000000000H00000
0000T0S000G0S00000000G000H0000
0000G00000000S00T000G000000000
0S0000S0000CG000000000T0000000
0000000000000S0000G00000T00000
000G00000000000G0000T000000H00
0000000000000000S00000T0000000
000000000000000S000T0000000G00
0000S000000S0000000000000000G0
0000000S0T000000000G00S0000000
00000000T00000G00000000000G000
000000G000S00000000000000G0000
S000G0T00000000000000000000000
00000S000S000G00000CT00000000G
00000000000000000000000000S000
00T000000G0GSS00000000H0000000
00T000G00000000000000000000000
0T000000000G000000000000S00000
00S0S0000000000000000000000000
0S0G0T0000000000000S0000000C00
000000G000000G00000S0S00H00000
0000000S0S000000000000000000G0
0000000000000000000000T0000000
0S000000000000000T0G0000000000
