00000T000000000000000S00S00000
00000000000T0000S00000G0000000
S00SG000C000T00000000000000000
0S000000000G0T0000S0000C000000
0000000SS0GT00000G000H0H000000
00000T00000000000000000000000S
00000000G0000000S0ST0000000000
00G000000000000000000000000000
00G000G0S0000T00000000H0000S00
ST000000000000S00G0C00G0000000
G0000000SS0T000C00000000000000
000000T00000000G000000000SSGC0
00000000000000000G00000S000000
000000T00000000000000000000000
000T000000000000G0000000000G00
G000G00000HT00H000H00000000000
00000T000000000000G00000000000
00000000G00G00000000000ST00000
S00000000T0G00000000000000000G
00000G000000S00000000000000000
00000G0000000G0000S00000000H0T
00S000000GS00C00G0000C00000000
ST00000G0000000G000000S0C00000
G0G000S00000S0000000CC0000C000
000G000000000000000G000S000H00
0000T0000000S0000S0000000000G0
0S000T000G0000S000000000000000
0G00000ST000000000000000G00000
0000000G00000000S00SG000000000
000000000G00000T00000000000000
