000000TG00S000000000
00T00S0000000000000G
0000000G000G0000000T
0ST00G0000000000G000
00000000TG0000000000
S0G00000T00G00000000
000000000S0000000000
0T00000S00S000000000
0G0000T000000000000S
0000T000000G00000000
0T00S0000000G00S0000
0000S0SC0T00000000G0
0T000000S00000000000
0000S0T0000000000000
000000ST00G000000G00
0000000000000T00S000
0000000000T0000G0000
0G000000000000000G00
000000000T000G000S00
0000000000S00000T000
