00SS0C00T0G000000000
0000T0S000000S000000
00TS00G000S0G0000000
0000000000000S000000
0G00T00000G0S0000000
T000G0G0S00000000000
0000T000000000S0000G
000S000S0000GC00000G
S0S0GTG0000000000000
0S000000000000S0000G
G000S0000S00000T000G
T0000000000000000000
000000S00000TG00S000
000S0G00S00000C00000
00000T000SG000000000
00SS00T000GG00000000
0G000G00000000000000
0000S00000000000GS00
G000000000000000T000
00000TS0000000000000
