0S0000000T000G000S000000000000
000000SS0000000000000T00000000
0000G000G0H00000000000000000S0
00T00000S0000000G0000000G0000S
000S00000000000S0G00C0G000000T
T000000000000000000000000S0000
0G00000000T00000G0000000000000
000000T000G00000000S00000SC000
00G0000000000000GHT00S00000000
0000000TG0000S00G00000000H0000
G00000000S00000T00000000000000
0000000000000000000000000G0000
T00000000000000000000000000000
00S00G00000T000000000000000000
00000000G00000T000SG000H000000
0000000G000000000000GT0000H000
T00000G000000G000000000H000000
G00000000000T00S000S0000000000
00000000G00000000000T000G00000
000000G0T000000000000000S00000
000000000000000G0S00S000000000
0000000S0SC000000000000000000T
00000ST000S0000000000000000G00
00000000000G0G000000000000S000
000S000000000000000000T0G00000
0S000S00000T000000000000000000
S000000000000S00000000000C0000
000G000S000000000000000000T000
0000S000T0000000000000G0000000
0000S00T00S0000000G00000000000
