0000000G0S0S0000000000000000C0
0T00000000000G00000000000SS000
00000T00S000000000000000000GG0
000S000G0000000G0000H000000000
000000000000000000000G00000000
00G0S0000000000ST0000000000000
T00000000000000000000G0S000000
000S000G0000000S0T000000000000
0S00000000000T000000000000000S
00000000000000000000T0G0000000
00000S000T00000000000000000000
T0000000000000000000000G0G000S
00000000000T000000000000000000
00T000000000000000000G00000G0S
0S0000000000T000000G00S00000C0
GG00000000H0000000000000000000
000000000T00000000000000000000
00GG0000H000000000000000000000
00000G0T000000000000G000000H0S
00000000000000000000G0000T0000
G0000000S00000000T000000000000
G00000000000T00000000000000000
00000000000000T000000000000000
000G0G0000000000000000000T0000
0S00G000S0C000000T000000000000
G000G000S0000000000000T0000000
00000S0000T000000000000G000000
S0S0000T000G000000000000000000
G00000000000000000000000G00000
000000G0000000000000T000000000
