00000S00S0000000000T
0TSS0000000000000G00
000000TG0000S000G000
S0000T00000S00000000
S000000GT00000000000
0000T000000000000000
0G00000T000G00000000
0000G0T0G0000S000000
000S000000000G000000
0S00000000S0T0000000
00000000000G000GT000
0G0T000000000000G000
0ST000000000G0000000
S000S000T00000000000
0G0000000000000000T0
0000000000000G000000
T0000000S0000000000S
0000S0T0000000G00000
00G0000S0000000T0000
000S00G0G000T0S00000
