0000T000000G00000000
000G0000000000ST0000
00G00000000000000G0S
00G0000T000000000000
0000000G000000000000
0000000G00000000G000
0000GS00000000000000
0T00S000000G000000S0
0000000S0GS0000T0000
0T000GS0000S00000000
00T0S00S000000000000
000000000G00000000G0
000T0000000000S00000
0000S0S00000TG000000
T000GG0000S000000000
00000000000T0G000000
0000000000G0S0000000
GT0000S0000000S0G000
0000T00S000000000S00
00T00000000GS00GS000
