00000T0000000000000000000S0000
000S00T000000000SG000000000000
0S00000G0000S0000G000000000000
G00000T00000000000000000000000
0000000000000G00T0000000000000
S000000000S0CG00000000000G0000
00000000T00G00000000000G000000
00T000000000G00000000000000000
00000000T00000G000000000S00000
0000000000T00000G000000000000G
0000T00000000S0000000000000000
G0000000G0000T000000000000S000
000000T0000000S000000000000000
00T0000G00G0000000H0000S000000
00000000000000000S0000S00G0G00
00000000000G0000000S0G00T00H00
0000000000000T00000000S0000000
000T0000000G000000000000000000
T0000000000000000G000S00S00000
00000000S00000000000T0000000S0
0S0SG00000000000000000000C0000
0G0G0000000000000S00T00000H000
00000S000000000000000000000T00
00T000000000000000G00S0S000C00
000000000000000000000S00000000
000S000T000000000S0000G00C0000
00000000T0G0000G0000000000H000
00G0000000S00S0000000T000GC000
0G0000S00G0000000000000000000H
00000000000SG0000T000000000000
