0000T00G0000G0000000000000H000
000000G00G0000H000T000S0000000
00000000000S00000000G0000000G0
000000SG00GH000000000000000000
00T000G00000000000000000000000
00000G0000SG000000000000000000
00000000000000S0000000G000000S
000T00G00S00000G00000000000000
00T00000G0S0000000000000000000
0000G000000000000000T0000S0000
0000000000000000000T000000000S
000000TG00G000000000000000H000
00000000000S000G0S00G00T000000
000000G000G000S0000T000H000000
0000000S000T000000000000000000
00ST0000000000GG00000000S00000
000G00000000000T00000000000000
00000000T000000000000000000000
0000S0S000C00000000000000000G0
00T0000000000S00000000G0000000
00000000000000G00G00H000000000
S00G000G00000000000000000000T0
000000000G0T000S00000000000000
0000000G00T0000000000000000000
0G0S000000G00S0000T0C00H000000
ST000000000000S0C0000000000000
T00S0000G000000000S0000G000000
T0000G000000000000000000000000
00000S00S000C0000000000000T000
000000000G00T0000000000000000G
