00000000000T00G00000
00G000000000000G0000
00000000T0000S000000
S000000ST00G00GC0000
000T00S00S00000000C0
00G0000GS0000T00000S
00T00000000000000000
00000000S0G00S0000C0
0000ST0000GS000000G0
000000G0G0S0S00T00C0
00000000S0000G000000
00000S00000S0G000000
000S00T00G000000G000
0000000T0000G0000000
0000GT0S0000G0000000
T00000000000S0000000
0G0000GS0000T0000000
T00000S00GG00S000000
T00G0S00G00000000000
0G0000000G0T0000S000
