00000000000S00T0000000G0000000
00000T000000000000000000G00000
00G0000SG0000000000H00S0000000
00000S0G0000000000000000000T00
0000000000000000000000000S0S00
000G0T00000000000000G000000000
00000T000000S0S00000000000000C
0000000000000T000G00000S000000
S00000S0000000G000T000000000G0
000000000GT000G000000S00000000
000000S0G000000000000000000000
000000000S00000000T00000000000
S00G00000000000000000000T00000
0G0GS000000H0H0000000000000S00
000G000G000000S00H00000000H000
000000000T0000000000000000G000
0000000000000000000000000T0000
000000000000000000000000S0T000
00000000000000G000000000000000
T00000000000000000000G00000000
00000000G000SS00C000C0000000CT
00T00000000000000000000000000G
00000GGS00000000000000S000000T
00000S0000000000S00G00GT0C0000
T0G000000000000000000000000000
000000000SG00000000000000T00G0
G00S00G000H000H000000000H00000
00G000000000000000000S00000GT0
000S0000000000000000S0T0000000
0T000000S000G0G000S00000C00000
