0000000000000000000000S00S0000
000S0G0000T000000S000000C00000
000000000000000000000000000000
0G000000G00000000H000000000000
0000000G00000000G000T000000000
000000S000G0000000000G00000S00
000000000000000000000000000000
0000000000000000T0000000000000
000000000STG0S00000000000000C0
T0000000G000000000000000000000
00000000000000G000T0000000S000
0000S000SC00000000000000000T00
00000G000000GH0S0000000000000S
0T00000000000000S0000G0000GH00
00G000000000000T00000000000000
000000000000S0000000G0000000G0
000S000T0SC000G000000000000000
00000G000000000TS0000000000G00
0000ST000000G00000000G00000H0S
S0T000000000000000000000000000
00000000000000T000000000G00000
000000000000000000000000000000
0000000G000T000000000000000000
000000000000G00T0000S00000S0C0
000TG0000000000000000G00000000
0000T0000000000000000000000000
0G0TS00000000GS000000000000000
00T0S0000S0000000000000G00G000
00S00S00T0G00000000000G0000000
000G00S0G000000ST0000H00000000
