0000000000000S0000G000G00S0000
0000S0000G0G00T00000000000S000
000S0000000T0000000000000G0G00
T00000000000000000000000000000
00G0000G0T0000000S00000S0C0000
00000000000000000000G000S00000
000000000S0000G00000S000000000
0000000000000000000S000G000000
0T000S0000GG0H000S000000000000
000T00G00G0000H000000S00000000
00000000000T000000G00000000000
000000000T000G0S00000000000000
0000000ST0S00000000G0G000000C0
000GSG000000000000000T00000SC0
000000G00000000000G000000T0000
S000000S000C000000T00G0G000000
0000000G0000T0G000000000H00000
000T0S000000000000000000000SGC
00GS00G00000S00000000000000000
000000000000G0T000000000000000
00000000G00000000000T000000000
000G00S000000000000T000000000G
0000S0G00000TS00000000C0000000
0S0000000T00000000000000S0G000
0000S00GS000000C0000000T0000G0
00000000000000000000S000000000
0000S00G0000000S00T00000000000
00000S00000000SC00000000000000
0GT000000000G0000000000000S0H0
000000000000000T0000000S000000
