T000S0000S00000000000G00G00000
00T00000G00000000SGB00000S0000
G00S00T0000000000000S0000M0000
0000S000G000000000000000000T0G
00SG000T00000S00G00000000000B0
000000G0000SS00000000000000G00
0G00G0S000B00000000T0000000000
T0000000000S00000000000000GSG0
000000000S00000G0G000000000000
000000000000000S000000000G00S0
000000G00S00G00000T0000000S000
T000000G00000000000000S000000S
0000T000000S000000000S00M000M0
0000T0S00S000000000000M0000000
00000000000000T0G00000S0000000
GS0000000000000000S00000000000
00G00G00000000T000B00000000000
000000000000000G00S00000000000
0000S000000000000000000T00SG0M
000000000000000000000000000G00
00S000G00000000000000000000T00
000S000000T0000000S000M0M00000
00000000000T000S0000G0G00000B0
000S00000000000G000SGMBT000000
00000T0000000G0000000000000000
000000000ST0000000G0SG00M00000
0G0000000000000000000G000000S0
0T000000000000000000G00000S000
000T00000000G0000000G000000000
G0000000S0000G00000000000T0000
