000S0000000T000000000000000S00
00000000000000000000T00SS0G000
0G0000000000000000000000000000
0G00000000000000000000T0SS0000
00G0000000SSG0000000T000C00000
00S00000GS000G000T00C000C00000
00000000000G00T00000G00000000S
0000000000000GS0GH0000000S0000
0000000000G0000S000T000000G000
0000G00000000000G00000S00H0000
000000000000000T00000000000000
S0000000000000000G000000000000
000S0000G00000000S00T0G0000000
0000000000G0T00S0000000S000000
0000000000000000000ST000000000
0000000000S000000S0G0000G00C0H
000000T00000000000000000S0G000
0000000S00000000G000T00S000000
000000000000000000000000000000
00T00G00000000000000000000000S
0S0S0000C00000000000T000000000
0S0000000000000000000000000000
00000000000000S00000S000000000
00G00000000000000000000G0T0000
0000000GT00S00000000G000000000
S0TS0000000000C00000C000000000
0000000000000S000T000000000000
0000000000000G0000T00000000000
0T0S0000000000000000000G000000
00000TS00000000000000000000G00
