0000GS00G0T00S000000
0SS0T00G0000C0000000
000000G0000G0T000000
0000000S000G00S000C0
T00000000000000S0000
0G0000000000SS000000
0T0000G00000000000G0
00TS00000000000G00S0
0000000000G0T0000000
G0000000000000000000
000S00G0G000S0C00000
000000G00000000S00T0
00000000G0000000000S
000000G000T000000000
0000T000000G0000G000
000S000S000000000000
000GG0T0000000S00000
0G000000000000000000
00000000S00S0T0000C0
00000000SG0G00000000
