0S0000S000000000G00000C0000000
0000000000S0000T00000000000000
00000000TGG0000H000S000000S000
00000T000000S00000000000000000
0T0G0000000G000000000000H00000
000000000000G000G00H0000000000
000000GG00HS000000000000000000
0000000000G0000S0G000000000S00
00000000T000000000000000000000
G000000S000T0000000000000000G0
0000000S00000000000000000T0000
000000T0000G000G0000HH00000H00
S00000000000000000000000000000
S0T000S0G000000000000000000000
00S0SC00C0000C0000T0000000000C
00T000G00000S00S00000000000000
000S00000G00000000000S00000G00
00000000000G00000000G0S0000000
0000000000000000000000000T0000
000S0000000000000000000T000000
00000000T000000000000000000000
00000000000S0G0000T000G000S0H0
00000000000000T000000000000000
G00000000000T00000000000000000
0000000SS0GT000000000000000000
00000000G00000000G0SS0T0000000
T0000G000000S00000000000000000
0000000G00T0000000000000000000
0S00G00SC000T000000000C00000C0
0000000S0000G00S00000C000000GH
