000000000000G00000000000000000
0000T0000000000000000000000000
0T0000000000G00000000000000000
00000000000000GS0G00000000000H
000000T00000S00000000000000000
0000000S0000000T0G000000000000
0000T0S0000000000000000000000G
0000S0000GT00000000S0G0H000C00
00T0G0000GS00S000000H000C00000
0000000000000SS000000C00000T00
00T000000000000000000SG0000000
0G00G00T000S000000000000000000
0S00G0000000S00000000000000G0H
0T00000000000000000000000G0000
00000000T0000000S000S000000000
00000T0000000000000000G00000S0
0000000000000S0T0G000G00000000
000T00000000000000000000000G00
T00000000000000000S0000000G000
0000000000000000T000000000000S
G0000000S0000000S00T0000000000
0000S00000000000000000000000S0
00SG0000000000S000000000G00000
000S000S0000000000000000000000
G00000000000000GHS000ST000000C
000000000000000000TS0000S00000
000000S00T000000000000S0000000
GT000000G0000S00000H0000000000
00T0S0000000000000000000000G0G
0000G0000000S00T00000000000000
