0000S000000000G0000000000S0000
000000000000T00000000000000000
G000000S000T00S0M0000000000000
000S000000000000000GTS00000000
0000000S000000000000000S000000
000000S000000000G00S0000000T00
00T0S000S000000000G00000000G0M
S0SM0GG0000000000000000B000000
00S000S00T000000G000000M0G0000
00T0000000000000000000G0000000
00000000000S000000000000000G00
0000S00000S0000000000000000000
0000000000000000GS0TSM00000000
00000000000000000S00000000000S
S0G00000000000000000000000S000
000000000000000000000000000000
S000G00000S000M0G00M0000000000
00S000000000S00000G00G00000000
00000000000000T0S0S000G0000000
0000S000000000S000M00M000G00T0
000000000000000000000000000000
00S000T000000000000000G0000000
00000000000000G00000T00000GB00
0000T0S000G000000000G000000000
0G0000S0000T00000000G0B0000000
0G0000S00S0000T0000000000G0000
00T000000000000G00G00000B00000
0000S0000T000000000S00M0000000
000000S00000000000000G00000T00
00000000000000000G000GTSBS0000
