000000000000T0000000S00S0C0000
0000000000000000000000G0000000
S00000000000GT0000000000000000
00000GG0000000000H000000000000
00000000000000G000000000000000
00T000G00000000SS00000C0000C00
00T000000000000S0S00C000000000
000GG00000000000000S0S0T000000
S000000T00000G0000000000000000
000G000000T0000000000000000000
00000000000GG0S000H00000000000
00000000T000G000000S00000000G0
00000000G00T0S0000000000000000
S000S000G0000000000G00000000T0
00000T000000G000S0G000H0000000
0G000S00T0G0000000000H00000000
00000000G0000T000G000000H00H00
G00000S00000G00H00T00000000000
0G0000000000000000000000000000
0000G00G00000000S0SH0000000000
0G00G0S000T000000000000H0S000C
00S0000000G00T0000G0SC00000000
00000SS0G000000000000T00000000
00000T00G0000000000G00000SS000
000T00000000000000000000000000
0000000000000S0000000000G0000S
00000000000G0T0000000000000000
000G00000000000000000G00000T00
00000000000000000T0000000000G0
0000000000S0000000000000000000
