00S000000000000000G0
0S00000000G000G00000
S000GT000000000000S0
0T00000G00G000S00000
T0000000000000G00G00
000000T0G0000000S000
00000T0000000G00G00S
00GG0S0000T000000000
0000000000SG00T00000
S00G0S0T000G000C0000
00000G0000T000000000
000000000000GS000000
0T00S00000000000S00C
00000S0SG00000T00000
000SS0000000000000TC
0000S00S000GC0000000
T00G0000000000G00000
0000000T000000000000
0G0000T000000SG00000
0000000000T000000S00
