000000000000G0000000G000000000
000000000000T0000G000000000000
000000G0000000S0000000000T0000
000000000000GSTSG0000000000000
0G0000000000000G00T00000000000
00000000T000000000000000000000
0000TG0S0G00000000S0H000000000
T000000G00000000000G0S0000H000
0T000000000000000S00SC00000000
0000000G000T0G0HS0000000000000
000000000000G00T00000000000000
0000000000S0000000000000000G00
00000000000000000T000000000000
S00S000T0C000000000G0000000000
G0000000000000000T000000000000
0000T00G000000000000000000G000
000000000000000S00000000000000
00000000G000000G000000HS000000
00S00000T0000000000000000S00G0
0T00000SS00G00000000000GH00000
0000G0000000000000000S00000000
0G0G000T00S000000000000H000000
00000T000000000S0000000000G0S0
00S000T00000000G00000000S00000
0S0G0000SC000T0G0H000000000000
00000000G000000000000000000ST0
000000G0000000000000G00000000H
0000000000S000000000000G000000
0000T000000000G000000000000000
000T00000000000000000000000000
