00G000000000000000000000000000
0000000000000S000S0G0000C0GT00
0000S0000000G000000000S0000000
0G00000S000000S0000000G0H000T0
0GSS00000000000000000000000000
00000000000000G00000S000000000
0G000000G00T000000000000000000
0000S0000000000000GS000000000C
000S000000000000G0000TG000S000
00G000000000000000000000000000
00000G0000S000000000000G000000
00000TG00S000000G0000H00000000
0000000000T0000000000000000000
00000000GG000SS00000000000000H
00000S0G0000T0000G00000S000000
00G0000000000000000000000TG000
000G000000000S0T0000S00000000G
0000000T00000000000000G00000G0
0T000G00000000000000000000G00H
00000T00000000000000G000000000
T00000000G0000000000000G000000
0000000000000000000G00S0000000
00G00000000000S0000000000GS000
000000GG0H0T000000000000000000
0T00000000000000G00000000000GS
0G00000S000S000000000000000000
000G000000000000000G0HS0000000
0SS0C00000G0000000000000000G00
00000000T0G00000000S0000000000
00T0000000000000S0000S0000C000
