00000000S0000000000000T0000000
000S0000T000000000000000G00000
000T00000000000000000000000000
000000000000000G00000000000000
0000000000ST000S000000000000G0
G0000000000000000000T0000000GS
000T00000000SS000C000G00000000
00000000T00000000000000000000S
0T0000000G0S000G000000H0000000
0000G0000000000000000S00S0G000
G0000T0G00000H0000000000000000
0T0000S000000G00S0000000G000C0
00000000G00G000000000000S00000
0S0000000S0000000000000000CG00
00000T000000000G00S0000S000000
G00000000S000T0000000000000SC0
S000S000000T0000000000000000GC
0000GGS0S000000000000000000000
G00000000000000000T00000G00000
00G00S00000000T0G0000000000000
0000000000000000000S00T000G000
000000TSGS00000000G00H00000000
00000G000000000GH0000T00000000
0G0000G00T000000000000000000S0
000G00000S000000SC00T000000000
000000000000000000000S0000000S
0000000000000T0000000000000000
00000000000000000000G00000G000
0000T00000000000000000000S0000
000000S0000000000000GG0T000000
