000G000TG0000000H000S000000000
0000000G0000000000G000H0000000
00000000000000S0000G00T000000S
00S000000000000000000000000000
000000T00GG00S00H000000000000H
00T0000000S0SC0000000000000000
0000000000000000000T0000000000
000000T0000G00000000000000G0H0
00000S0000GS000000GH000000TC00
00000T000S00000000000S00000000
00000000G000000000000000000000
0T0000S000000000000000G000G000
000000000T00000000000000000000
000000000000000000T0S00000S000
000T0000S00000000000000000000G
000000000S00G00T0000S000000000
0000S00000000000TS0000000G000G
000S000T0000G00000000000000G0H
000G0T00000000000000000S0000G0
000000G0000000G00T000000000000
00000S0000000T0000000SGC00C000
0G000000T00000000000000G00S000
0000000000S0000GS0000T00000000
000G0G000000000000000000000000
000000S00000000000000000000000
000000T00000000S000000000000S0
000000S000000000000000000S0T00
0000000T000S00000000000000000S
00000T000000000000000000000000
00000000S0G00000G00000H00000T0
