000000T0G0000G000000
0G0G000T000000000000
0G0G00S0000000000000
00000000000T00000000
0T0000G0000000S00000
0000000S00S000T00000
S000G0000S00T0000000
0000G00T000000000000
00000000G0000GS00000
0T0000G000000G000000
0000000000000000000T
S0T0000000S0G0000000
000000000S000S0000G0
0000000T000000G00000
0000000000G0S000000T
STG0000S000000000000
GT00G000SS0000000000
0S0TGG000000S0000000
0T000000000G0S00000G
G00000000000G0000000
