0T0000000000000000000000000S00
0000000000000000000000TG000000
00000000000GG000000TH0000S0S00
000000000T00000G0G000000000H00
S0000S000000000000000000000000
0S0000000000000000000000000000
0000G0T0S000000000000G00000000
0000G0T000S000000GH00000S0C000
00000000000000G00GT000H0000000
0000000000000T00S000G00000S00G
G000000000000S0000000S00000000
00000S000T00000000S000G0000000
0000T0G000S0000000000000000000
00GG00T00000000000000000S00000
TS0000000000000000S00000000000
0000T00S0000000000000G00000000
TS00S0000000000000000000000000
0000G00TG00000000H000000000000
000S00000T00000000SG0000000000
00G0000S00000000TS000000000000
G0000000S0000000000G000000T000
0000SG0000000000000T0000000S00
S00000GTG000000000000000000000
00S0000000000000000G0000000000
00000S0T0000000000000000000000
00000000T000000G0000000000S00S
T0000000G00000000000S000000000
00000000000G00S000000000000G00
0000000000000000000G0000000GS0
000000000000G00000000S00T0000G
