0000000S000000000T00
000000000G000000000G
000000T00S000000000S
00TG00000000SG00S000
0T000GSG0000S0000000
000G00GS0000T0000000
00000000T0000000000G
S00000T000G00000G000
0000000000G000000000
000T000G0G0000000000
00G0T00S000000GS0000
00T0000000000000000S
S0000000000000000S00
000G000000S0000T0000
0000000000S0T0000000
T000000000000000G000
0000S000000SG000G0T0
S00T0000000000000000
00000T000000000G00S0
T0000S0000G000000000
