0t000000000000S00000000000S000
00000000000S00g000t00000000000
000000000000000000000000S000S0
00000000000000000SS000gg000000
00000S00g00t000000000g00S000M0
0g0000000000t0000000S0000g0000
0S00t000000000000000000Sg0000M
00000000000g0000g00000t0000000
000000000000000000t00000000000
S00000000000S00t00000000000000
000000000t00g000000g0000000000
0g00g000S00t0S0000000000M00000
00000000000000000000SS000M0000
0gt000000S000000g0B00000000000
00S0g000S00t00000000000000000M
0S000000t0000Sg00000g000000000
0g000gt000B0000000000000000000
00000000000S0000000g0000g00000
t00000000000000000000000000000
00S000000000000000g0g000000000
00000000000000000t0g0000000g00
t0000g00000000000000g000000000
0000000g0000000g00000S0000S000
0Sgt00000000000000000000S0M000
S00000000000000000g00000g0000t
0000S00g00g00000000000S0M00000
0g00000S00t0000gB0000000S00000
t0000000000000000000S000000000
000000g00000t00000000000g00000
0t00000000000000000000000g00S0
