0000S00000000000g0000000000000
0000t0000Sgg0S0000000000000000
000t0000S00000000000000S0000M0
000tS000g000000000000000000000
00g00000000000000000000000t000
tS000000000000000g000000000000
00000t00000S000000000000000000
000000S00g0000000t00g000000B00
00000S00000t0g000S000000000000
0000000000t0000000000000000000
0000000000000000t00000000g0000
000000g0000S000000S000g00B0000
g00000000000000S00000000000000
g0000SS000000000t0M00000000M00
0000000000g000000000000t000000
000000S0000t0S0000000000g000g0
000000000g00t00000000000000000
0S0000S0000000000000M0g0000000
000S0t00g0000000000SM0g0000000
g00000000000S000gS0000M000000M
0000000000000000tg00000g000000
00000000000t00g000000000000000
00000000t00000000S00000000000S
0t00000000000000000g0000000000
g000000S00000t00000000g0000000
S000000St0M0000g0000000000g000
0000000g000g000000000000000000
00S00000000000g00000g000S00t00
000000000000000000000000000t00
000000g0g000000B000000t0000000
