000G0000S00000T00000
00G0G00000000S0000S0
0S00T00S0000000G0000
S00000000T0S000C0000
00000000000000000000
00000000T00000S00S00
000000000000G0S00T0G
000G0000G000000T0000
00000T000000G0000000
G0S000S00C00000G0000
00000000000000000000
00G000000000G0000000
000000000T0000000000
00000G00000G0000S000
0000000G00T000000000
00T00000S0000G00S00C
T000000000000G000000
00S0T000000000000000
00G0T0000000000G0000
0000GSS000CT0000G000
