000S00G0000S0C00C0000000000000
S000GS00000000C0000000000CG000
G0000000G0S00S00T0000H00000000
S0T00G000000000000000000000000
0000GS00000000000G0T0000000000
0S000000000000T000000G00000S0C
00G000000000000000G00T00000000
00000000000000G000S000SG00T00C
00G000000000000000000000S000T0
00T0000000000000S00000G0000000
0000000000000000000000S000S000
00000G000000000000000000G00000
0000000000000000T0000000000000
00T0000000000S0G00000000000000
00G0S000S00000000000000G000000
0000000000000T00000000S00G0000
00S0S00C0000C00TG00C0000000000
0T00S00S00000000000000000G0000
0000000000000T00G0G000000S0000
000000000T00000000000000000000
G0GH000H00000000000T0000H00000
T00000000000000S000G000000000G
000S000G000000G0000S000T000000
000GT00000000000000G000S000000
0G000000000000000000000T000000
0T0000000000000000000S00G000S0
00T000000000000000000000000000
00000S0000000000000S000G0G0T00
T00000000000G0G00000000000HS00
00S00G0000G0000000000000000000
