0GT000000S000S000000
00000S0G00S0G0000000
00T000000000S0000000
00000000S00G0T00G000
T00000G0000S00000S00
00G0000000T0000000SG
00G000G00TS000000000
0ST0000000S0000G0000
0T000000S000000S0000
S00000000S0000000000
00G00000000000000000
T00000000000000G0000
T0000000000000000000
00GS0T00000000000000
000T0000000000000G00
00S0000G0G0T0000S000
0000000T000000000S00
0G0000000G00000SS000
000000GTG00S00S00000
0000T00000000000G0S0
