0g0t00000gB00000SS000000000000
0t000000000S000000S00g00000M00
00000000000000000000000S000000
00t00000g000000000000000000000
000S00000000000t00000000000000
00000000t00g000000000000000000
0000000000g00000g000t000000000
0S0g00000t0000000gS000000000B0
0t00000000000000S000S000000000
00gt000000000g0000000000000000
000g000000000000St000000000000
0000S000000000000S00000t00gM00
t00g00000000g0S000000000000000
S0000000t00000S00M00g000g0000M
00SS00000M0000000000M00000M000
000t00000000000g00000000000000
00g0000S0000000g00S000000M0000
0g00S00S000000g000M0000000000t
00t0000g00000S00Sg0B000M000000
00000000000000000000000000g000
000g000S0000g00000000000tB0000
0t000000S0g0000000000g0000000S
0S0000000000g00000000000000000
0000000000000g0000000g00B0t000
0gtS0000000000g0B0000000000000
00000000Sg000g000000000000B000
t000000000000000000000000S0000
St0000g0000000000g000000000000
00000000000000000000000g00t000
0000t0000000000g00g00000000000
