000g00S000000000000000000g0000
g00000000t000000000000S0000000
0000000000000Sg0tS0000g0000000
000S0g000S000000g00B0000M000t0
000000S00t000000000000g0000000
00g0t00000gS000000000000000000
000g000S0000S00000000g00000000
0000000000000000000000000000t0
0t000000g0000g0000000000B0B000
000000000000S0000000t000000000
0000g0g0000000B00B00000S000000
0000g000000S00000000S000000000
0000000000S00S0t00000000000000
00000g000000000000000000000000
000g00gtBB0000000000000000B000
000000000000t000000000g0000000
00000S0000000g00g0000000000000
0000S00000S00000000M0t0g000000
g0S00S0000000000t0000M00M0000M
0S0g0000000000000S0t00000g0000
00000gS00000000000t00000000000
00000000S00t000000000000000000
g000000000000000t0000000000000
000t00000000000000000000000000
0000S0000g000000g0000t000000S0
0000000S00000000g000000000S000
00g00S000000000000gBB000000000
0g00000000000g0000S0000B000000
000000000000t000000g00Sg0B0000
00S0000000000000000000000S0000
