00T000S0G0000000S000
0000000000G0000S00T0
00ST0000000000000000
00G000000000000G000S
0000S0S00000GC0000G0
000000S000000T000000
00000T00000000000000
00000000T00000000000
000000T0000000000000
T000G000G000000S0000
000T000G0000S0000000
G000000000000S00000T
000000000SG0T000G000
0T000000000000000G00
T000000G000000000G00
00T0000000000000S00S
0TG000000S00SG000000
0T000000000000000000
0000000000000000GS0S
000T0S00000G00G000S0
