0SS000000000G00000GT0000M00000
0T0000000000000000S000000S0000
T00000G0GS0B0B000B00000000000S
00000T00000000000000000000000G
00000T00000000G000000000000000
0S000000GG000B0B000B000T000000
T00000000G000000000000SGS00000
000000S0000T000G00000000000000
000T0000000000000000S000000000
000000000T0000000S0G000S0000M0
0000000S00S0000MT0000G00000000
00000000000000T00SGSG00000000B
000T00S0000S000000000000000000
0S0000000000000S00000000000000
00000000000000T0S000000S00M000
00G0000000000STG00000000000000
00000S0T000000G0G0000000000000
000000000000S00000000GT0000000
00T000000000000000000G0000G0B0
00000000000000T00000000G000000
T000000S0000000S00000000000000
000000000000G0000000000000000S
00G00000000G00000B0000B0000000
000G0S0000000T00000000G0000000
0000T0000000G00000G0B000000000
000000G0000000S000SM00T00G00B0
00GT00000S00000000000000000000
00000S0SG0000G000M000000000T00
S00GG00S0000B000000000000000B0
00000000000G0000000000G000S0S0
