00000000000T00000000000G0000G0
0G00000000G000000H0000000T0000
0ST000000S00000000G00000000000
000T00000000S000G0000000000000
0000000000S000000000T000000000
0000000S0T000000S0C0G000000000
000G00000T0000000000S000000000
00000000000000000SG00T00000000
00S00S00000C000G00T00000000000
000000000000000000000000000000
00G000000S0000000000000000000G
0000000000000G0T0G000000000000
00000000000S00000000SG000CT000
S0000000GG00S0000000T000000000
0000T00000G0000S00G000H0000S00
0S0000000S00G000C0000000000000
00000T0000G00000000000000S0S00
0SG000GH00000000000S0000000000
T0000000000S0S0000G00000000000
000G000TG000000SH000000000000S
SG0000T00000000000000000000000
000000000000G0000S000000000000
G00000000S00000SC00000G0000000
00000S0G00S0000C0000T0G0000H00
000000000000T00000000000000000
00000000G00000000T0000S0000000
TG0000000000000000000S00000000
0000000000000000000S0000000G0S
0000000000000S00G0000000000000
000000G0000T0000000000000S0000
