000000T0000000000S000000000000
0000000S0000G00000000000000T00
0000000000G000000T00000G00S000
000000000000T0000S000000000000
000000S00000000T0S000000000000
00000S0T00G000000000000G000000
00000S000S000T0000000000000000
000G0000T0000000000000000S000G
0000000000000000T000000GS00000
000000000T000000000G0000000G00
000T00G00G000000H0000000000000
000000000000000000000ST00000S0
0000000000000000000000000G0000
0G000000000G00S000000000000000
0000S00T0000000000G000000000G0
0G0000T0000000000G00000S000000
000000000000000G000T00000000S0
0T0000000G000G000SS00000000000
00000G00000000SS0000000000000G
000000000T00000000000000000000
00000G0S00000T000000000G0000H0
00000T0GS000000000S000000000G0
0000000000000000000000S0G00000
000000S000S000G000000000G00000
0000000G0000000000T00000000000
0000G00000000000SS0000000T0000
000000000000S00000000000000T00
000G0G000000000000000T00000000
000000000000000000G0G0H00S0000
S000000000000000000000S000T0C0
