0STT0000000T00000000
0000T000GG0000G00S00
0000GT00S00000000T00
00000S00G00G00000000
0000000ST0GS00000000
000000S0000G00T00000
0000000G00000000S000
00G00SS0000000000000
0G0000000G0000000000
0T0000000000S0GG00S0
000G000T000000000S0T
00G0000S00T0000G00TG
000000T000000000000S
000000G000000S000000
000S000000000000000S
00000000S0G00G00G000
000000000000GS000000
00000000000S00000000
000G000000S000S00000
S000000000S000000GS0
