000St000000g0000S0000g000M0B00
000000000000000000S0t00S000000
t000g00g000S000000000000000000
0S000000g00g0t00S00000000M0000
00t00g000000S000000000000g0S00
00t0000000000000g0000000gS0B00
gt000g000B000BS0B000000S00M000
000000000000000t00000S00000000
0g00000t00000000000g00B0000S00
tS000000000000000000g000000000
00000000000S000000000000000000
00000gg000tS00000000S000000000
00000S0t000000000g0000000g0000
S0S000000t00000000000000000000
000t0000g000000000000000000000
000g0t00000000gS00000000000000
0000t0000000g000S000000S000000
00000000S0000g0000000000000000
000000000000000000000000000S00
00000000t00000000000S00000S0M0
0000000000t0000g000S000000S000
S0000t000000000000S00000g00000
00000000S000000000g00000000000
t00000000000g000000000S0000000
00000000000000000000S000000000
00S0t0000000000000000000000S00
t000000000000g0000Sg0000000000
0000g00g0S000000000B000t000000
0000000000g000000000000000000g
0Sgg000t00000B000000B000000000
