0000000TG0S00S000000
000000000S0G00SC000T
0T00000S000000000000
000000T0G00000000G00
GST0000000G000000000
0000T00000000000S000
00000000000T00000000
00G00000000G000000S0
000GT000G00000000000
00G00000000000TS0000
G000000000S000000000
0G00000000G000000000
G00000T0000000000000
0T0000000000000000GS
0000GG00STS000000000
00T00000000000000000
T000000000G0000S0G00
000T0S0GG00000000000
000G00000S0G00000000
TG0G0000000000000000
