S0000000000G0000S0000C00000G00
00000T00000000000000S0S0000000
T0000000000000000000000G000000
00G00S00000S00000000000000G000
0000000S000000G0SG00000H0000C0
00T0000000G0S00000000000000000
000S0000000S0G0000T00000000000
0G00000000S000S0T0000000000000
00000000T000S0S000000000000000
0T0000000000000S00000000000000
0G000T00000000S00S0000000GC000
00000000000T00000S0000000000S0
000000000000000000S000T0000S00
000000000000000000G00000000000
00T000000000000000000000000S00
000000000000000S00G000000000T0
0000T00000000000000000G0000000
000000T0G00000G000000000000000
00T00S000000000000000000000000
00000000000000S0T00G000S000000
00T000000000GS0000000G000000SH
00000T00S000000000000S0000000C
000000000G000T0000000000000000
000000000000G0000000000G000000
00G000000000T0S00000000000G000
0S00GS000000000000G00000000000
00000000000000000000000000000T
S0T000000S0000000000000C0C0G00
000000000000000000S00000GS0000
0G00000000G000000000000T000000
