0000000G00000S000000
00000000T00000S00000
000S0G000T0000000000
00T0000G000G00000000
000G00000000000S0000
000000000G0000000000
0000000S000S00000000
0T0S0G00000000000000
0000G000000000000S00
0000000S0S000000T000
000000G0000000G0SS00
0TS0G00G000000000S00
G00000000S00000G0000
000GTG00000000000000
0S00SG0T000000000000
00000T0S000000000000
00000000S000000T0000
000T00000S000000SG00
0000000000000S0000G0
0TG00G00000000000000
