00000000000000TSS00000G000G000
S00000S0G000000000000000000000
0GS000000000000000000000000S00
0000000G00G0000T0S00H000000H00
00T0000000S0000000000GG0000000
000G00000S00000000000000T00000
000000G0000000S000S000C0T00000
000000000000G000S000000S00T00G
0T00000000000000S0000000000000
00000T0G0000000000000000000000
0000T0000G00S00000S000C0000000
0T000000000000000000000GS0000S
T00000000000000GG0H0000S000000
000T000000000000S00000G00000S0
00T0000S0000000G0S000G0000C000
00000000000000S00G000000000S00
0S0G00000000000000G000000S0000
0000000000000000G0000000000000
000000S00000000000T000S00000G0
0000000000000000T000S000000000
0G000000TS00000G0000000000S000
00000T00000SS000000000G000G000
00000S000000S0T000000000000000
00000000G00000000000000000GH00
0000000000000S000000T000000000
S0000000000000000T000000000G00
00S000T000S00000000000000000G0
SS0T000000000C0000000000000000
000SS0T00000C0000000G000000000
TS000G00000000S000000000000000
