00000000G00000000000T00S0000G0
00T0000S0S00000G0000000C000000
0000000000S0000000000S00T00000
0000000TG00000SG00000000000000
000000000000000000G0000000G000
00000S00000000000000000T0000S0
00000G00000000000000S0000000GT
0000GTG00000000000000000000000
0T0000000000S0S000000000G00000
T000000000000000S000000000S0C0
0000000G00S00000G0S00000000000
00000000000G000000SG0T0S00H000
0000000000G0000000T00000000000
0G0000000000S0TS00000000000000
0T00000000000000000000G0000000
000T0000000000G0000G00000000H0
0TG000000000000000000000000000
0000000000000S0G00000000000000
00S000G0GS000000T0000000000000
000000000000000000GGT00H000000
0G000000000000000000000000S000
0000G0000000000000000T00000000
000000000000000000000000000T0S
00000000G000000G000T0H0000000S
000GG0H000000S000000000000000S
000G00000G000000000S000T000000
0000G0000000000ST0000S00000000
000000000000000000S000G00000G0
00S000000G000G0000000000000000
0000000000000000TS000000000000
