000G0SG0S00000CC000000000000H0
000S000S00G0000T00000000000G00
000T00000000000000000S00000000
00S0000000S0C0000000T0C00000C0
00000000000S0000S000C00T000000
00S000000000G000T000000000000G
000G000000T00000000000000000S0
0000000000S000000000G000000000
0G00T0000000SS000000CC00G00000
0S0000000000000000S0000T000000
000000000S00000000000000000000
000S00000000000000000000000000
00S00ST0000GC000000000000G0000
0000T00000G00000000S000S000000
00000S0SG00000T000000000C0G000
0G0000000000000000000000000000
T00S000000000000000000000000G0
000G0000000T0000000G0000000000
0000000G00000000000000S0000000
00S000000000000000000000T00000
T000000000000S00S0000000000000
S00000G00000000000000S00000000
0000000000T00G00000000S0000000
000000000000000000000000000000
000000000000000000000S00000000
0000000000000000000S00000S0000
00T000G00000000000000000000000
00000000000000T000S00G00000000
0000000T0S0000000G000000000000
00000000000000000000S0G0000000
