00S000000G000000G000
000SSG000T0000000000
00000000000S0G0S0C0G
00G000G000S000T00000
000S0000000000000S00
00000G0SG000000T0000
T000G000S00000000000
00000000S00S0000C00T
000T000S000000000000
0G00T00000000G000000
000T00000000000G0000
S000G0S0TC00G0000000
0T000000000000000S00
00SG00G0000000000000
000G00S000G000000000
G00000G00000T0000000
T0000SS0000000G00000
S0000G00000T0000000G
00000S00000000000000
000000000T0G00000G00
