0000000000t0000000000000000000
00S00000000t0000000g0000000000
0g000g000t00S000B0000000000000
00000S000000000000gg000000BB00
0t00000000000S0000S0000000M000
0000S0000S0M00M0000000000000g0
00gt0000S000000000000000000000
000000000000000000000000000000
Sg00000000000000000000S00000g0
00000000t00000000000000SS00M0g
00000g00000000000000000g000000
000000000000000000000000000000
g0000gS00000000000000t00000000
000000g000000t00000000000000gS
000000000000000t00g00000000000
000000S0S0g00g0000000000000000
0000000t00000000g00S0000g00000
00000000000Sg00000000t00S00000
0000S0000g000000000SMt000000M0
00g0S000t00000000000000g000000
0000000000000S0000000t00000000
t000g0g00000000000000B0000000S
000S000000000000000t0000000000
0g0000000000000t00000g00000B00
00000000000000g0000000t0g0000S
0000000000000S00SM00000000t000
00000000000000000S000g0000000S
00000t0000000000000S0000000S00
g0000S00g0t00000000000000000S0
000g0000g000000000000000000000
