0T00000000G0000000000000000000
0000T00000000000000000000000S0
0G0G000000000000H0000000000000
000T00G00000000000GH00H0000000
0TS00SCG0000G0000000000000000C
00S000000T000000000000S0000000
0000S00000000000000000000000S0
00000000T0000000000000000G0S0G
0000G0G00000S0S00T00000000CCH0
0S00S0000C0000C0000000000000T0
000TG00000000000S0000S0G000000
0000000T000000000S0000000000G0
0T00000S00000000GS000000000000
000000000000000000000000000S00
00T0000000000000000000000G0000
000S000000000000G00TG000000000
0S000G00000S000000G000000000C0
0000000T00000000S0000000000000
0000000000000000G0000000000S00
000000000000000S00000000000G00
T000G0S00000000000000G00000000
0T000G000000000000000S000S0000
0G000000000000T0000GH00000S000
0000T00000000000000000S0000000
GG0T000H0000000H00000000000000
00G00G0T00000S0SC0000000C00000
00000S0S0000000000000000000000
0000G000000000000000000000000S
00SS000G00000T0C00000000000000
00000000000000000000S00T00000G
