GS00000000T00000S000
0T00000000000000SG0G
000000000000000S0000
00000000000S000000G0
000000000T0S00000000
0000000000T00S000000
00G000000000S000T00S
000T0000000000000000
0000G0000G0T00000000
000000000000000T0000
0T0G000S00000000S000
00S0G000000000000S00
00S000000000000000T0
000G000000T000S000GS
00S000000000T000S000
0000000S00000T000000
S00000000000G0T00000
000000000S00000G0G0S
T000000000000G0G0000
T00000000000000G0000
