0000T0000000000G0000G000000000
0000GST000000000000000000G0000
00000000G000S0000000T000000000
S0000000T00000S00000C0G0G00H00
000000000000G000T0000000000000
G0G000T000000H000H0000H0000000
TS00S00G00C0000C00000000GH0000
G0000T0G0000000000000000000S00
T00000000000S0000000S000000G00
S0ST0G0000000000C00000000G0000
T000000000000000000000000000G0
00000000000000000S0S000C000000
0000000000G0S00G000000T00000S0
000000000000000000000G00GS0000
000000000000G00000000000000G00
000S00TG0000SG0000000000000000
0000G00000000S000G0000000000S0
G00000000000000T0000000G000000
000S00G000000000T00000000SC000
00S0000G00STC00C00000000000000
T0000000000000000000S000000000
0G000T0000S0S00000G00000000000
G00G0000000000H0000000S0000000
0000000SG0000S0000GT0000000000
0000000000000000S0000000000000
00000S00000S0CT000000000000000
000G0000000000000T00G000000000
000S0000000000S000000000000C00
0S000000G0000000T0000000S0C000
S0000000000000S000T0CG00000000
