S000000000000000S00C0000000000
000S00T00000G0G000000000000000
000000000G000S000G000000000000
0000000000000000000000000S000S
S00000000000G00TS000000000C0G0
00T00000G0000S0000000000000000
000000S00000GG000000HT00000000
S000G000000GH0000000S0T0000000
00000000000000T0000000000S0000
G0000T0000000000000000000G0000
00000000000000000000000000G0T0
0S0T00000000G00000000000000G00
00000G000000S00000000000000000
0G000000000000G00000000H000000
000000000000000T0000000S000S00
T00G00000000S00000000S00000000
0000000S000G00T0000000000S0000
000000000G0000000G00HT000000S0
S0000000S0000TG0000000000C0000
S0000000G00T000000000000000000
000000TS000S000G000C0000000000
00000T000000G000000G00S000S000
00000000000T0000000000000000G0
G0000G0000T0H00000000S00000000
0000000S00000S000000000G00T000
000000GS000G00000000000000000T
000000000000000G00000S00000000
0000S00S00000000000C0000000T00
000G0S00000000000000T00000000S
00000000000T0000000G000000G000
