000000000000G000S0ST00CG000000
000S00000TG000000000S0GC000H00
00T0S00000S000C000000000000000
00000000T0000000G0000000S00000
000T0000000000000000000S000000
G0000000G000S00S00000000H00000
0S0000G000000000000000T0000000
000000T0000000S000000000000000
00000000000T0000S0000000000000
00000000G000000000000000T00000
G0000000000000000000G0000000S0
0000G000000000000000000000000T
000G0G000H000000S00000S0000000
0000000000000000000T0000000000
000000G00G000000S000H000000000
000000000000000000T00000000000
S0000000000000000T000G0000G0S0
000000000000000SG000000000000S
S0000000GS000000C00000G0000000
G0000000000SG00T00000000000000
000000S0000000000T000000000000
0000G0000000G00000000SH00S0000
T000SG00000000000000000000S000
00000G0000000000000000000S0000
0000000000S0S000C0T00000000000
S0GT0S0C00G000000H000000000000
0000000000S0000000T00000000000
0000GG0000SS000000H0000C000000
00000000G00S00000T000000000000
00000000000000ST00000000000000
