000000T00S0000000G00
000T0000000000000000
0000000000G0000000ST
00000000000S000S0000
0S00G0000000000T0000
00G000000000000T000S
0000000000G00SS0000T
00T000GGS00000000000
000G00000S0000000000
0T000S00000S0C0G00G0
0000000ST0SG00000000
000T0SG00G0S000000C0
0G00S00T00000000000G
000000T0000G00000000
GS000000S00G000T0000
00S00000000000T00000
000000T0000000000S00
00000000000000S00000
0000000000G000000S00
G0000000S0G000000000
