TS000000G00000000000000000G000
00000000000000TG00000000000000
0000G0G00T00S00000000000000000
00000000000000T00000G00000000S
G000000G00000T000S000000S0C000
000T0000000000000G00000000SG00
000G0G000H000000000000S0000000
000000000S0000000000T000000000
00S000G0000000000000T00S000000
000000TG000000S00000000S0G0000
0000000000000000000000S0000000
00000T00000000G0000000000S0000
00000000T000000000000000000000
0000S0000S0000C00000G0G0000000
0S00GS000G0000TH00000000000000
00SGT00000000000S0000000000000
0TG0G00000000000000000000000H0
000000T00000000000S00000000000
0000GSS0000C000G0H000000000000
T000000000G000000S00000000000G
0S00000000000SG000G000C0000000
000000000000000000S0000G00000S
G000000T0000000000000000000000
0000000000000T0000000000000000
0000000000000000G000000000G000
T0000S000000000000000000000000
000000SG000S00C0000000000G0000
00000000S000000000000000000000
00000000000000000S0G00S0000000
0000000S0G00G0TS00000000000000
