0000000000T000000000G00G000000
G0T000000S0000000000SCC0000000
0000G0000000000000000000000000
00000000G00000000GHH0000000H00
000000000S00000000000S00000000
0000000G0G0HS0000000000T000000
00T0000S0000G00000000S0000CG00
00000000T000000000000000000000
000000G000000000000G0000000000
0000T000000S0000000GG00H000000
0GG0000000000T00000S0000000000
000000000000G0000000000000ST0G
000S0000000000000000S0T0C00G00
0G00000000000G0T000000000000H0
00000000000G000T000000G00H000H
S000T0000000000000000S00000C00
S00000000000000000000000000000
0G0000000T000000G0000000000000
000000000000000000000G000T0000
00G000S00T0000000000S0000G0000
00000000000000T0000000000G0000
T000000S000000G000000000S0C000
00000T00000000000000000000000G
G0000G0000000000000TH000000000
00T0G0000S000G000H0000000S00H0
T0000000000000000G00000000G0H0
000000000S000G000G00000S000T00
G0000000T0000S000G000000000H00
0G0000T00000000000000000000000
0000GG0H00000000T00000S00SC000
