0S00G0S000000GT00000C0000H0000
00000000T0000000SG00000000000G
00000SG00000S00000000000000000
T0S00000000S000000000000000000
00000000000000000000S00000G000
00T0S000000000000G00000000000G
00000STS000G000GC00000C0000C00
00T0000000000000000000S0000000
0000T00000000000G00000000000S0
0000T000G00000000S000000000000
G0G00S000T00000000000000000000
000000S0000S000000G0000T000000
G000000000000T000G00000000H000
00S000S0T0000C000000G00GC00000
00000000000000000S000G00000000
S000000000G00000T000000S00000C
000S000G00G000000ST0H000000000
00000000GS0G0000H0000000000000
S000G0000G00S00000000000000000
0000000000000000000G0000000000
000000000G0000000000G00T000000
00000S00S0000T00000000C0000000
0T00GS000000000000GS000000000C
00T00000G0000S0000000000000GS0
000S000S000G0T00G0000000000000
000000S0000G000000000000S00000
00000000000000000G0000000SG000
00000000S000000000000T00000S00
0000000G0000G00000000000000000
T000000000000S0000000000000000
