000G0000000GS00000000000H00000
00000T000000000000000000000000
00000S00000000000000000T00S00C
00000G00T000000000000000SS0000
000000000000SGGS0000H000000000
0T0G0000000G000000S0S00H000000
G000000000T00S00000000G000000H
0000000000T00000000S000G00G00H
0000S0000G0000GT00000S00000000
00000GS0000G00000000T0000SH0C0
000G0000000000ST0000SG0000000H
0S000000000T0000000G0000000000
000S0G0000S0000000C00000000000
0000000000000000G00TS000000000
0000000000000T0000000000000000
T0S000000000000000000000000000
000000T000000GG0000000000S0000
G0000SS0000000G0T0000000000000
00G000000G000T0000000000000000
G00S000G000000000H000S000C0000
00G000T000SS000000000C00000000
00000S0G0000000TG000000H000000
S0000000T00000S00000000000000G
00S000000T0S0C000000000000000G
000000000000000G000000TSG00000
00000000000G0000000G0000H0T000
G00000GH000S000000000000000000
00000000000S00000000000G00000S
00000000T000000000000000000000
S00G0ST0000000G000C00000000000
