0GST00000G0000000000
00000T0000000000S000
00G00000000T00000000
0000000000G00000000S
0G000000000GS0000T00
S000S0000G00000G0000
000S00T000000G000S00
00000S0S000000000T00
000S0000000000000000
000GS00000S0T0000000
T00000000S0000000000
00000000G000000000G0
0000000GT0000S000000
000G0S000G0000S00000
TG00000000000SG00000
00G000000000000G0S0T
000T00000S00000000G0
000S00T0000000GG0000
0T0S0000000S000G0G00
000000000000S000G000
