0000000G00T00000000S0000G00000
0000000T0000000000000000000000
00000000000T0000000000G000S000
00000000000000000000000000000T
00000000000T00000GS0G000000000
0000T000S000000000G00000S00000
0000000000000000000S00000T0000
TS000S00C000000G00000000000000
0G0000000T000000G00000000000H0
000000000000000000000000000000
000000GT0000000000S00000000000
000T00000000000000S0000000G000
G000G00000000H0000000000000000
0000000G00000G000000H000000T00
0T0G000000000000000000S00G0000
000T000000G0G000H00SS000000C00
00SS00T00C00000G000000G0000000
00000000000T000000000000000000
00000000000000T000000000000000
0T0000G000G0000000000000000000
GG0T0000000000000H000000000000
00000000000000000T00000000000S
000000G0T000000S000000G0000000
00000000000000S00S000000000000
00000G0000000000G0T00000000000
G00000T00000000000000S00000S00
0000000T000000S000000000000000
00000000000G00T00000S000000000
00S000000000000000000T00000000
000G0000S00T00S00000000000000G
