0000000000g0g00000000B00t00000
00g00000g0BB000t00000000000000
0000S0000000000000000000000000
S00S00t000M0000000000000000000
0000000000g0000SS000000000tg00
000000000000000000000g00000000
00000t00000000000S000000000000
0S000g00000000000000000t000000
00g000000000S00000000g00000000
00000000000000000000S000000000
00000000t000000000000000000000
000S00000000000000000000000000
000000gt00000000S00g00000B0000
0000000000000000000St000000000
00000000000000000g0000g0B00000
0000000gt0000000000S0000000000
00S000000gt00000000000000gS0MM
000000000000000000t00000000000
000000000000000000000000000000
00000000000000000000000S0000g0
00000000t0000g0000S00000000000
0000g0000000000000000S00000000
g0000000000000t000000000000000
00g00000000g0000000000000000B0
0t0000000000000S00000S00000000
00g0g000BS00S000Bt000M000M0000
S0000t00000S0000000M0000M00000
0t0000000000000000g00S0000S000
0000t0000000S00000000000000000
00000000000000000g00S000t00000
