00S0000000T000000SG00000000000
00000G00G0000B00B000000B0000TB
0000T00000000S00000000000000G0
0T0000000000000000000000000000
00000000000000000S00S000000000
TG00000000000000G00000000000B0
000000T00G00000000000000000000
0000000000000000000000G0TS0000
000G000S00000000000000T000000S
000G000G000000B0000S0000000S00
000000T00000000000000S00000000
0T000000000G000G0S000S00B00000
0000000000T0000000GG0000000000
00000000000T00000G000G00000000
000000000G000S00S00000000T0000
00000G000000000000T00000000000
00000GG0T000000000000000000000
00000000T0000000000000000G0000
000000000000000000GG000T000000
00G000000000000000T00000000000
0000SG0GB000000000000000S0M000
00G0T00000G00000000S00000000S0
000000000000000000000000000000
000G000000T00000000000000000S0
000000T0000000G0000G000B000000
0000000000000000000S0000000000
00000000000000000000000000000T
S00T0000000000000000000000000G
0000T0G000G000B000000S00000000
0000G00T0000000000000000000000
