00S000000000G0000000
0000T0G0000000000000
GST00000000S00000000
G0T00000000000000000
0000S00000000000000S
0SG0000000000000G00S
000000SG0G00S00T0000
SGT000G0000000000000
00000G0000000000000S
00G000T0000000S000SG
0G0G00T0000000000000
00000S0T000000S0000G
0000G0G0000T00000000
00S0000000G0S00000GT
0G00T00000000S000000
T00G00G000000SS00000
S0000000000000G00000
00000G00S00000000000
T000000000S000000000
0T0S0000000S00000000
