00T000000G00000G0000
0T0000GG00S000000000
00G0G00000T000000000
0S00T00000000G000000
0G0SS0G0000000000000
0000000000000G0000S0
000000S000S000G00000
00000000000GT0000G00
S000TG000000000S0000
00000000S0T00000G0G0
000000SS00G0000000G0
0000000T000000000000
00T000S0000000000000
000000S0000T00000S00
0T0000SS000000000000
00GG0000S000S0000000
T0G0000000000G000000
000000G0G000000000TS
T0000GS0000000S00000
000000000S0000000000
