T00000G000000000G000
000000T0000G0SS00000
000G0000000000000000
0000000T00000000G000
000000G0000G000000T0
0ST00000000000000000
G0GS0TS0000000000000
00G0T0000G0000000000
000000000000000000T0
S00G000000000G0S0000
0000T0000G000000G000
0G0000000000000S0000
00000T0S000000000000
0000T0000S00000SG0G0
000000S000G00000000T
0000000SG0G00000T000
0000GSG0000T00000000
00G0G0S000S000000000
0000000000G000000000
0000TG0000000000G000
