0000t000000000000S00000000g00S
00000000000000t00S00000000g000
00000000000000t00000S000g00000
00000000000000000000000000g000
000000000000000000000000000000
0000000000000000000000000g0000
g0t000000000000000000000000000
00Sg0000000000000S000t000g0000
0000000000St00000S000000M0M000
0000000000g000g000000000000000
000000g000Sg0t0000000000000000
0000gg0000t00000000000000000S0
0000000S0000000000000000000000
000t00000000000000000000000000
000000000000000000000000000000
000000000S00000000S000Mgt00000
00000000S000t000000000000g0000
SS0000000000000000000000000000
00g00t000000000000S00000000000
000000000gS0tg000000B000000S00
0000t0000g00000000000000000000
000g000000000000000000t0000000
00000000t000S0000000000000S000
000000000000t00000g0000000S00S
000000000000000000000000000000
00000000000000t00000000g0S0000
000000000000000000000000tg0000
S00000g0000000S00M0000000000g0
00000S0t0000000000000000000000
00St00000000000000000000000000
