0000ST00S000000000000000000000
G000000000000000000000000T0000
00000000000000000000G000000000
000000T00000000000G0G0H0000000
0000G0000T0000GH00000000000000
00000S000000000S00C00000000000
000G0T00000000G00S000000000000
G0000T00000000000000G000000000
S000000G00000000000S0G0C0000HH
TG0000G00HS0000000000000000000
0000T000000G000S000000S000000C
0000000ST00GG00000H000000000H0
0000TG0000000S0000G00000000000
00000S0000TS0000000000G0000G00
000000000T0000000000000000S000
0000G00000000000G00000000S0000
0000S00000SG0000T00000C0000000
0000G0S0000G000000000000000H0T
00S0000S0000000000000G00000GH0
0000000000000000000000G00S0000
00000GG0000SS000H0C00H0000000T
0000G0G0000H000000000000T00000
S000000000000S000GG000000H0000
S0000000000000000T0000000000G0
00000000000000000S000000000000
000000000000000T00000000G00000
S0000000000000000000000000T0S0
0T0000000000000000000000000000
000000000000T00000000000000000
00T000000000000000000000G0G000
