000000000000000000G00000S000T0
0T0000000000SSC000000000000000
000G0S0T0000000SG0000000000000
G0000000G00000000000000T000000
0000S000000000SC0000000000G000
000S00000000000000000000000000
000000000000000000000S00000000
0T0G000000000000000G0000000000
000000000000T0000000G000000000
SS0GG00000000000H0000000000000
00ST00000000S00G00000000000000
00G0000000000TS000000000000000
0000000S0S0T000000000000000000
0000000000T000000000G000S0S000
00000000000000000S000000000000
000000000S000S00000000C0000000
000T00000000000000000000000000
T0000000S000G0000S00000000000G
0S00000000T00000000000000G0000
G0000GT000000S0000000000000000
0000S00000000T00G0000G0S000000
00S00000000000000T000000000000
000T0S00000000GS00000000000C00
000000000000000000000000G0S000
00000000000T00000S000000G0000S
0G00S0000000000000000000S00000
000000000G00000000000000000000
G000000G00H0000TS0000000000S00
000000000000T00000000000000000
00000000000000000000TG00S00000
