t0000000000g0000000000g0000000
000g00t000g0000000000B00000000
00000000000g000Sg000000000S000
S00S000000t000000g000000000000
St0000SM0MM0000000000000000000
g0000S000t00g000000000000B0SB0
0000000t00000S0000S00000000g00
00g0000000t00000g0000000000000
0000t00000g0g000S0000000000000
0000000000g0000000S00t000000S0
000000000000000000000000000000
0t0000000S0000000g000000000000
00000t00000000g000000000000000
t0S00000g00S000000M0000000M000
0000000000S0S000g000000000t000
00t00000000000000g0000S00g0000
00000000gt000000000g00000000B0
S00000000000000SM000t000000000
0t000000000S000000g0000000g000
0000S00000000000000t000000000S
0000000000000S0000000000000000
gt0000000g0S000000000000000000
t00000S00000000000000000000000
S00000000000000000000t000S0000
0000000000g0000000000S00000000
g0000000000000000St00000000000
000gg00000000000000000000t0000
0t000000000000000000000S000000
000000000000000000t0Sg00000000
0g00000000000t0g00000000000000
