0000G0000ST0000000G0
000000GG0ST0S0000000
0000S0TG000G000S0000
0T00S0G0S00000000000
0G0000000T0S00000000
00S000000000000S0000
00000G0S00GS00000000
000GG0T0000000000000
T00G0000000000000000
00G00G000000000S0000
S000G00S0000000000T0
0000G0G00S00000S0000
T00G000S0S0000000G00
0000S000000GT0000G00
0000TS000S0000000000
000000G00000000G0000
000G0T0000S000S00000
T0000GG000S0000000S0
000S00G00G0000000S00
00000000000000000000
