00000000g0000000tS0g0000000000
0000000000t000000000g0g0000000
gg0000000000000000000000S00000
t0000000000000g000000000000000
000g00t00000000000000000000000
0000000000g00000000000000g0000
0t000g000000000000000000000000
00000g0000000S00000000000000g0
00000000g0t0S0000000000S00M000
00t0000000000S000S0000g0000M00
00000S0000tS00000000000000000g
t00000000gS0000000000000000000
0000000g00000t00000000000S0000
0S0000000t00000000000000000000
0000000000000000t0S000g0000000
00000S000g000000g0B0000000S000
000g00t00000000000000000000000
0000000000000000000000g00gt0S0
000000000000000000000000000000
000000000g0000000g0000S000S00M
t0000000000000000g000000000000
g00000000000000000000000000000
00000000g000000S00000000000g00
000t0000000000000000S000000000
00000g00000S00tg0S0000M0000000
00000gg00000S00000000000000S00
S0000g0t0000000000000000g00B00
0000t000000000000S000gS0000000
000000000000tg000000000000000g
0000000000000000gS0000000000S0
