000000T0G000000000S0
000000000000000G0000
0000SG000T0000000000
00000G000000S0SG0000
0000S000S00000C00T00
00T000000000000G0000
0000000000S00S0C00G0
000T00000S0000000000
G000000S000000T0000S
0T0G00000000G0000000
G000000000000000G000
0000000S00S0T0000000
000S0000000000000000
0000000S00000G000T00
00G00S00000000000000
ST00000G000SG0000000
00000S00000SG0000G00
G0T0000000S0000G0000
0000G0T000000000G000
000000S000000TG000GS
