00000000T00000000G00
0G000000000000000000
00T00000000000000000
00000G00000T00000G00
000000000000000000S0
000S000S00T000000000
00S0T00000G0G00000S0
00T00000000GS0000000
G00000S00T0000S00000
G0000000000GS0000000
00000000000000000000
GT0G0000000000000000
0000000T000000000SSG
00S00000TG00000000G0
00ST0000000000G0S0G0
000T0000000000S0G0GS
G00T00000G0000000000
00000000000000000T00
0G000TG00000000000SS
T0S00S00000000000000
