000S000000000000TS00000000000M
0G00000T0000S00000000000000000
G000000000000000TG0B000000B000
ST00SM00G00000G000000000M00000
0000000S0000GT00000G0000000000
00000000000S00000000S000000000
0S0000G0000T000G00000000000000
S000S000M00M00000G00T0GBM00000
00T00S000000S00000000G0000000M
00S00000SM00000000000000000000
00G000G00000000000000000000S00
000000000000000G00000000000000
000GS000000T000000000000000000
0000000S0000GG0000000000000000
00000T0000G00000000000000000SG
0000000TS000000000000000000000
G0000G0000S000000000BB0000000T
0GG0B0T000000000000000S0000000
0000000TG000000S000000000000S0
00000G00000T00S000000000000000
00000S0000TG0000G00B000000B0B0
00000GG00000000000B00ST0000000
00ST000G000S000000000000000G00
0000T0000000000000000000S00000
00S0000T0000000000000000000000
00000000000000000G00T000000000
00000000S0000000000000T00S0M0G
000000000000S0000000T0G0000000
00000S00T000000000000000000000
000000000000000000000000000T00
