000000000000000G00000000000000
G0000T000000000000000000000000
000000000000S00000000000000000
0T00S0GS0G0000C000000000000000
00G000000G000T00S0H000S000000H
00000000000S000000GS000GC00000
00000T000000S0000000000000000G
0000000T0G00000000000000000S00
00000000000G00S000G00T00000000
0000T000G00000000000000000S00S
00G0000000000000T0G00H00000000
000000000T0000000S000000000000
T0000000000G0000S0000GHHH00000
00000S00000000000000T000000G00
00000000000000000000S00000S000
000000000000G00000000000000000
0G000000T00000G0000000000HS00S
0000000S00G00000TG00S0000000C0
0000000S000000T0000000000000G0
0000GG0000000000000H0000T00000
G0S0000000000000T0000000000000
000000TG00000000S00G00000000S0
00S0000000GS00000T000000000000
000G00000S00000T00000000000000
T00000000000000000000000000000
0T0000S0000000000000G000000000
0TG000S00000G00000000000S000H0
0000000000SS000TG00000C00C0000
0SS0G000000000000GH0000H000000
0T00000000G0000S00000000000000
