0TS000000000000000000S00000M00
000000000T00000000000000000000
00ST000000S000000000000G000000
0000000T0000GS0000000000000000
00000S0T0S0000G000000000000000
0S0000T0000000S000000000000000
0000000000000G0000000000000000
0000000T00SS0G000G000B00000M00
000000000G00S000000G000000TB0B
00000000SS00000000000000000G00
000T000000G0000000000000000000
0G0000T000000GS000000000000000
00000T0000000000G000S0S0000000
000000T0SS000000000G0000000000
00000T000000000S00000000000000
000000000000000000G000T0000000
000G0TG00S0000S000000M00000000
00000000000G0000000T0000000000
000000S0000000S00000000000MG0G
0000S0000000000000000G0T000000
00000000000G000G000000000000T0
0000T000000000000000000000S000
000G00G0S000S000M00000000M00T0
00000S00000000000000000S0T0000
0T0000S0000000000G00000000S0M0
S0000000S000000000000G00000T00
000G000T000S00S0000M000G000000
0000000000000G00000000000TG000
0000000000000S00000000S00M0000
00000T00000000S000000000000G00
