00000T00000000000000000000000S
000000000T000000000S00000000S0
00G0000000000000000T0000000000
000000000000000000000000T00000
000000000000000000T0G000000000
0000000000T000000000000G000000
00S0000000000000S0000000000000
0000000G00S0000000000S0G000000
0G000S0GH0H0H00000000000000000
0S00000000S0000000C000000000C0
00000000000T00000000S000000000
0000G0000000000000000000000000
000GT0000000SS0000G000H00H0000
G000000000000000000000G0T00000
S00000000000000000000000000000
0ST0000G000G0S0000000000000000
G00000000T00000000000000000000
000000000S000T0000S0G000000GC0
000SS000000000C0000000G0000000
000G0S00000000S0000000000000G0
00000S0S0000G0G0000C000H000000
S0000000G000000G000000H0000000
0G000000000000G00T00000S00S000
000000000000G0SS00000000C00G0C
0000G00000000000TS0G000000S0C0
0000T00G000000S000000000000000
000000T0000000000G00000S00000S
00000000S0S0000000000000000000
000G00000G0S0000T0000H00000S0C
0000S00S00000C000000000000G000
