000000000000000000000T00000S00
000S0000SC0000C00000000C000T0C
00000000000G00000S000T00000000
0000S000T00000000G000000000000
00T0000000000000000000000000S0
000T00000000000G00000000S0G000
000000000GG0000000T000000S00H0
00000000000SG00000000000000G00
S00000T00000000G00000000000000
0000000T000000000000000000S000
00000000000GT00G00HH0000000000
0000S00000G00000S00G000000H000
00SS00000C00000000000G00000000
0S0000000000000G00000000000000
0000000000T0000000000000000000
0S000000S00C000000000000T00000
000S000000000T00000000000000S0
00S0G00000T0000000000000000000
000000000T000G0000000S00000000
G00000000T00000000S0000G000000
00S000000000000S000000000C00T0
000000000000000000000000000G00
000000000000S00G0G000000000000
00G0000000000T0000000000000000
0000000000S000000000000G0S00G0
00T000000000G00000000000000000
0T00S0000000000000000000000000
T00000S000000000000G00000SC00C
00000000000T00G0000000S00G0000
00000000T000000000000G0000S000
