00000S000000S000TG0000000000C0
00T000000000000000000000000000
0000000G000GS0S00000000000T000
T000S000000S00000000C000000C00
000T000000000000S0000000000000
0000000000000GT000000G00000000
0000000000T000G0000000000S0000
000000000S000000T0G00000000000
000000000000000000000000G0S00T
00000G000000000000T0000G000000
G000000T0000S00000000000000G00
00G0G00H000000000000000000T000
00000000000T000000000S000S0000
00000000000T0G000G000000000000
0000000000000T00000000S0000000
00000T0000000G00G0000000000000
000000S0000000000GS00000000000
0T00S00000000000000000000000S0
00G0S000000T000000000000000000
0000G00T0000000000000G0000H000
00000000000000000000T000000000
0S0ST0G000C000000GHC000C000000
0000000000000000S00000000000G0
G0000G00T000000000000000000000
000T00000000000G0000S000S00000
T0000000000000000000000G0S0000
0000000SS0T00C000000000000C00G
00ST0000000G000000000000000000
G000000000G0000000000000000000
0S0000000000S00000000000000000
