0T000SGS0G00000000C0
00G0T000000000000000
00000000SG00000GS000
G00000G0000000000000
0G0000000T000000000S
000000S00S0000GT000G
000000GSS000000000G0
T000000000S000000000
00000000T0000G0000G0
0S000000GT000000000S
0000S000000000000S00
00ST000G00G000000S00
000000000000ST0000G0
0T0000000G0G00000000
0T0S0000000000000000
S000000000T0000000GS
T0000000000S00000000
0000GG00000000000000
000000G00SS000000000
00G0000SG0S0T00C0000
