0S00000G0G0000H000000000000T00
0000000G000T000S0000G000000H00
000000000000000000G00000SS0000
0000000S0G00000000000000000000
000000000000000S0T00000000000G
000T000000000000000S0000S00000
00TS00S00000000000000000000000
00T00G0000G00000000000000H0000
T000S000000S0000C0000000000000
0T00SS0G00000000C0G00000000000
00000000000G0G0000000000T0000H
000000G000G00H0000S000000000S0
00000000T000000000000G00000000
00000000T00000000S000000G0S000
00000000T00000000000000G000000
00000SST0000000000000000G00000
00000000000GT0000000000000G000
00S00000000000S000000000000000
0000000T0G0000000000S000000000
S0G0S000000000000G00000H0000C0
0T0GS00S0000C0G000000000H00000
G00000T0000000000000000G0H000S
0000000000S00000000000000G0000
00T00000000000S0000S0000000000
000000000000000000000000000S0T
0000S00000000000000S0000000000
0T0G00000000000000000000000000
000G0000000G0000000T0000S00000
00T00S0000000000000000S000000C
00000T0G00SS000000000000000000
