0T0S0000000000S00000
00G000T0G00000S00000
G0000000SS0000000000
00000S000000000S0000
0000G00G0S0000T00000
000S00G0000000000T00
000000T0000000000000
00000G0S00S000000000
00T00S000000000S0000
GG00000000000T000000
S0G0G00000000000S000
000000GG00S00000000T
000T00000S0000S00000
000T0S000000G0000000
GG0000000000T0000000
00S00000G00S00000000
00G0000SS00000T00G00
000000000000000000G0
000T000000000GS00000
00G00T000S00G0000000
