000000000000000000T0
000T0000000000000SG0
G0000000TS0000000G00
0S00S0000T0G00G00000
00000G00S00T00000000
000S000S0000000T0000
0T0S0000G000000G0000
0T0000G0S00000G00000
00000000000T00000000
0000G000000000G0000S
0T00000S000000000000
000T00S00000GG000000
0T000000000000S0GG00
000000000000SS000000
00GG0000000000000000
G0000T000S0000000000
S0000S0G000000000000
000T00G000000G0SS000
S0000000GT0000G00000
0T0000G0G00000000000
