000G000T0000000S0000
000000T00S0S00000G00
0T00G000000G00000000
000TS0000S0000000000
0000G000000000T00000
0000GT0000000000G000
000000000G0000000000
0000ST0000S000000000
G000G000T00000000000
000000000000000000SG
0T000000000000000000
T000G000SG00000S0000
0T000000SS0G000C0000
000S00TGG00000000000
000000T0000SSC000G00
000000S00TS0000C0000
G0000GT0000000000000
0SG0000G000000S00000
00S000000000G00G0T0S
0T000000000G00000000
