0GTGS000000000000000
000000000000000G0T00
000000GS00000G0T000S
0000S000000S00T00000
00000000S000S000G00T
000000SS000000000G00
00G000G00000000000T0
000G000000G000000000
00G0S0000G0000T0S000
0TS00S00000000G00000
00000000G00000000G00
0000000000G000000T00
0S0000000000000000T0
00TS0S000G0000000000
0000T00000000000S000
0S0000000000T0000G00
000T0000S000000S0000
0T000G00000000000000
000S0T0S0G0000000000
0G0S000000000S0000G0
