00T00G00000000S00000000G000000
S0000G00S00G000T0000000000H000
00G0S0000000000000TG0000HHH000
00000000000S000000000000000000
00000000G00T00GS00000H00000000
T0000S00G00000000000000000G000
00000S000000S000000G00000000T0
00S0000000S0T00000000000000000
0G00G0S0000000000000T000000000
0000000000000000S00000000G00T0
000000T0000000G000S00000000000
000000000G00000T00000000S0S000
0000000000000G0000000000000000
000000GS00000000000000T000000S
000G00T000G0000000000000000000
0GTS00000000000000000000000SG0
0T00S000G00000000GH000000HHS00
000000000T000000S0000000000000
0TG00000G00000000S000000000000
00000000000000000000000000T000
0000TG000G0S000H000000000S0C00
0000000T0000G00000000G0000000S
00000G00000000000000G00HT00000
000000000000000000T00000000000
00000000T00S0G0000000000000000
000000000000000000000T00000000
00T000000000G00000000000000000
0000T00000000000000SG0G00S0000
0S000ST000C00000000000C0000G00
0000GS0000S000G000H00000000000
