00000000000000000tS00000000000
0t000000000000000000g0S0000000
000000000000tS000000000S000000
0000000t00000000000g0000000000
0000S000000000000S00t000M00000
0000000000g00t00Sg000000B0B000
0000000t0000000000000000000000
0000000000000t0000000000000000
000000000S00t0000S000000000000
000000000S00000S0000000000000t
0g00g00000000000B000000t0BB000
000g000000000S0t00000000000000
00g0t0g0000B0000000000000000SB
0000000000000S0000000t00000000
0g000000000S000000000g0t000S00
0000g00000000000S00S00g0000000
00000000000t0000000g00g0B00000
000t0000000000000000000000g00g
0000g00000000000000tS000000000
000000000000000000S0000g000SM0
000000g000000000000g00S0000000
00000000S0000000000000g0000000
0g0000000t000SS000000000000000
000000S00000000t0000S000000000
0000S000St0000000000000g0000g0
000000g00000000000g00000Bt0000
S0g0000g0t0000S000000000000000
0000g00000000000000t0000000000
S0g0000t000S0000000g0000000000
000gt0S0000000000S000000000000
