000000S00000000000000000000000
0t0Sg0S000M00g000MM00000000000
000000000S00S00000g00000000000
0000S00t00000000000Sg000000000
000ggSB000B000000000000B00000S
00g00000g0S0000B000000000S000t
0t000000000000S00000g0000g0000
000000000000000000S00t0000g000
g0000000S0000000000S0M00t00000
000S00000000000g000S000g0000t0
000S00000000S0g000M000000t0000
t0g0S0g000000000S00000M00B0000
00000000g0000000000000t0000000
000gt0000000000000000000000000
0000000St0000g0000000000000000
g00g00t00000000000000000000000
00000g000000000S0000000000S000
0gg000t000000000B000000000000B
t0000000000000S0000000000S000M
00000t00S000g0000S0M000000000M
g000000000000000000S0t00000000
00000000000gt00g0000000000B00B
000000000000gt00000000S0g0S000
00000t000000000000000000000000
gg0B0000000000B0000tS000000000
ggt00000000000000000000000S000
0t00000000g0000g00B0000000000S
00g00000000S000000g00000000000
g000t00S0000000S00gBB000000000
00000g000S00t0000000000g000000
