0000000G000000000000000000SS00
000G00S0T0000000S0000000000000
000000000000000000000000T00S00
SS000000000T0000M0000000000000
000G000000TS0000000000S0M00000
0000S00000000000000S000000G000
T00000S000000000000000000S0000
000G000000G00000000000B0000S00
000000GS0T000000000000000000S0
000T000G0000000S000000S000G000
000000000000000S000000T0000000
00S00000000000000000T00000G000
0000000G00T0000000000000000000
0000000G0000000000000000000S00
00000000S000G0000000S0T0000000
00000T0G00000000000000S000S000
00S0000T000000000SM00M0G000000
00000000000T0G00000000S0000000
00000000000000000000000000TG00
T000000S000S000000000000000000
00000000000T000000000000000000
0000000000T0000000000000000000
00000000S0000G00S0000M00G0T0B0
000000000000000000000000000000
G00T00000S0000000000S000000000
00000G000000000000000T00000000
000ST0000000000000000000000000
0000G00S0T00000000000000000000
000000000T00000000000000000000
00000000000000000000TG00G000S0
