0000000000000000000T0000000000
000000000000000T000000G0000000
000000S000T0000000G00G00000000
00000G000000000000000000000G0S
0000000T0000S00S0000000000000G
000ST0S000000000C00000000G0000
0000G0000000000T00000000000000
000G00000000ST0000G00000000000
00S000S000T0000000G000000G000H
00000000T000000000000000000000
T00G0S0000000S000000000000000G
000000S00000000000G00S00000G00
000000G0000000S0000G00000000H0
00000000S0000000G00000000T0000
000S000000T000S00000C0G0000000
000000000000000000000G000000G0
000T0000000S000000000000000000
0GT0000000000G00H0S00000000000
0000T00000000000S0000000000000
00G000000000S00S0000000000000T
0G0000S00SG0C00000000000000000
0S00000000G0T000SC000G00000000
0000000000000000000000000G0000
000000000000000000000000G00000
000000000000000S0S00000C000G00
0000G000S0S0000000GH0000000000
0G000SS000000000G00000000C0000
000000000000000000T00S0000S000
000000000S000T0000000000000000
0000000000G00000000000S0000000
