00000S000S00000000T0
0T000000G000000G0000
S00000G00000000000S0
000000TS0000000G0000
00000000000G00000S00
000S0T000SG000000000
00T0S0S000000000000C
0000G00G000000T00000
0GT000000000S000000G
G00G0000000S00000000
000T0000S0000S000000
0G00000000000S0S000G
00000000S000S0000T00
0T0000000000G0000000
00T00G0000000000000G
000000T00G0000000000
000000000000000T0000
0S0000000000000S000G
0000T000000G00000000
00S0000T0000000GS000
