T000SG000000000000000000G00000
0000000S0T000000000000S0000000
00000T000000000000000000S00000
000000000000S0000000S0G0C00000
00000T0G0000S0000000000000G000
000SS0C000G00000G0000000000000
0000G00S00T000000000000SG00000
G00000TG0000000H00000000000S00
00000S000T0G000000S000G000C000
000000000G00T000000S0000000000
0S000T00S000C00000000000000000
S00T0G0000000000000000G0000000
0000G0T00000000000000000000000
0000S0000000G000S0000000G00000
000000S0000000000G0S0000000TG0
000000G0S0S0000T00000000000000
00S0000T00000000000S000000000C
000S0000000000GT00G00000000HS0
000000G0S000000S0G00C00T000000
00S0000S000000T0000000C0000000
000000000000000000000000000000
0000T00S0000000SC0000000000000
00G0T000000S000000S00000000000
0000T000S0000000G0000000000000
0000000000000000G000000TSS000G
000000SG0G000H0000000000000000
0S0T00000000000000000000S00000
0G0T0S0000000000000000G000000H
000000000G000T0000000000000000
0TS000000000000000000000000S0C
