00000000000G00000S0000TG000000
000G00000000GS000000000000H000
000G0000000GS000000HT0000S0000
G0T000000000G00000000000H00000
0000000000000T0000000000000S00
000000000G00000000000000S00G00
00S000000G00000G000000H0000000
0GSS0000000000G000000000000000
00G0G000S00000S0T0000000H00000
000G0000ST00000S0G0000H0000000
0G00000000G0000000000000000000
0000G0000000G00H0S00S000000000
0G00T0S000000000G000H000000000
00000000000000000000000000T00G
00GT0S00000000000000G0S0000000
0000T000000000000000G000000000
00000G00S000000000S0000000000G
0G0000G00000000000000000000000
0000000000000G0000000000S00000
00000T0000000000000000S0000000
00000000000000000G000S00000000
0000000ST00000000S00000C000000
00S000G00S0000T0000000000G0H00
0G0000000000S00T00000G00000000
00T00G000000000000000000000000
0SG0G00000000H00T00000000S0000
0S0G0G00000S00C000000000000000
000000T00000000000000000000000
000000000T00000000000000000000
0S0S00000000000000000GT0000000
