0S0G00000000S000G000
SGT00000000000G00000
000000GT0000000S0000
00G0000000G0000S00TS
00TG0000G0S0S0000000
00T000000000000G0000
0TS000S00000000000C0
GG0000000000000000S0
000000000000G0G00000
0G0G000000000000S00S
0000G000000GT00S0000
0000G0000T0000SSG0C0
G000T00SG00S00000000
00000000000000G0G000
000000000000T00GG000
000G0000TG00S0000000
00000000G00000000G00
0000G0T00S0000000S00
GS0T00000S0000000000
0S00000G0TS0GC000000
