0000000T000G00000000GS00000000
G000T0000000000000000000000000
000000000G000000000S000SG00000
TS0000000000S0000G000000000000
0000000000T00000S000000G000000
S0S00000GC00000000000000000000
000000T000000000000000S0000000
00000000000SGS0GT000000000H000
000S0GT000000000000000000000S0
000000000S0000T0S00G0000C00000
0000000000T000000000000G000000
00000000000G0G0000000000S00000
000000000000000000000000S00000
000G000000S0S000C0000000000000
000000000000000000T00000000000
0000000000000000G00000000T0000
0000000000G0000000000G0000H000
T0G0000000000000G000000000000H
0000T00000000000GS000000000000
00GG00TS0000000000000H000000S0
000000000S00000000000000G0G000
00G000000000000T00000000000000
000000000000000G0000SS000T0000
0000000000000G000T000000000000
000000S0G000T00S000G00H0000000
0000000000000G00000000G0000000
000000G0000T0000000S000000S000
0000000S000000G0T0000000000000
G00S00000G00000000000000000000
0000000S0000T0G00S000000000000
