T000000000000000000S0000000000
0S000000S0000000G00000M0000000
0000000000G0G000T0000000000000
000000000000T0S000000000S00000
0000000000000S000G000000000S00
000000000000000000G00000000000
000000000SS000000T000000000000
00G0000T00000G0000000000000000
0S00TSM0000000M0000M00000M00GM
000000000000ST0000000000000000
00000000S00T0S0000000000000000
0S0S0000000000000000000T00000G
0000000000000000G0S0000T000S00
0S0000000T000000G0000G00000S00
000000000S0000ST0000000G000000
ST00000000000000000S0000000000
0T0000000000S000G0000000000000
00000000S0S00000MT000000000000
0G00000T00000000000000000000G0
0000000000T00000G000G0S00B0000
0T000000000000000S000000000000
T0000000000G000000000000000000
0S000G000000000000T00000000000
000T000000000000S00S00G00G0000
000000T0GS0G0000000000000000S0
0000000T00000000000000S00S0000
00G0SG0000000000T0000000000000
G0000000T0000GS0000S0000M00BMM
T0000000000S000000000000000000
000000000000G00000000S000S000T
