0000tS0000000000000S0000000000
00000000000000000000000S000000
000t000000000000g0g000000000S0
00000000000000000000000Sg00000
000000t000000000000S0000000000
000g000000000t000S000000000000
0000000S0g000000000000t0000000
00000t0000000g0000000000000000
0000Sg00t00000g000000000000000
000000000S000000t0000000000000
0000t0S000000000000g0S0g000000
0t00gS00000000000S0g0000000000
000000000t0000000000000000g000
0000000000S0000tS00000000000g0
00000000000000S000S00000000000
g0t00000000000000000000S000000
0S000Sg00000000000000000000000
0S000000St00g00000000000000000
0000000S000000S000000t00M0000M
0000g00S0g00S00000000BM0000000
0000000g0000000000g00000000000
g0000000000000000000000000g000
0St000g000000000000000000000Sg
t00000000000000000000000000000
0t00000000000000S000000000000S
00S00t0000000000S00M00g000g000
000000t0000000S00000S0000M0000
000gg00000000tB00S000000000000
00000000000g0S00000gB0S0000000
0t0S00000000000000S00000000000
