0S00G00T0G0000000H0S0000000000
0000G000000G0000SS00T00H000000
0000G000000S000000000000T00000
0G0T0000000000G0S0000000000000
000000000S00000000000000G00000
00S0000000000T0000000000000000
000000T00000S000000000000G0000
0000000SS00000GT0C000000G00000
000S00000000000000000000000000
0G000S00000000000S000T00000000
0000000S00000T00000000S0G00000
000000000S0000000000000000000G
00000000000000G000000000G0000S
00S00T0000000S000000000000C000
0000000T0000S000000000000000S0
GT0000000000000000G000000000H0
0T000G0000G0S00000000000000000
000000G0S00T00000000000S000000
S000G000T00000000G000000000000
0000T00000SS000000000000000000
0000000000000000000000TG000000
00000000000000000000G00000GHS0
T000000000000SG000G00000000000
00000T000000000000000000000000
000000S000000000000000S0000000
0T0G0000000000G000000000000000
0000000000000S00000000S000000T
T0000000000000000G0000G0000000
00000000T00G0000000G0S00000000
G000G000000000000000S0SH000000
