gS0g0000000000000000B00000000B
00000Sg000000t0000000g00000000
0000t00g00000000000S0000000g0S
00S000S000MM0t0000000000g00000
00000000000SS0g00000000t000000
0000g00000000000000t0000000000
S0000000000000000000S000000000
0000t000000000000S0g00S0000gBB
000000g0000000t00g00S000000000
0t0000000000000000000000S00000
000t00000g0g0B00000000000000S0
t000000000000000000000000g00g0
00000000000S0S000000000M000000
00t0000000000000000000000gS000
000000t000S000000000S0000g0000
000000t000g000S0000000g00000S0
g0000000g0000000000000S000S00t
000000000S0000g0000S00000000g0
0000t000000000S000000000S00000
000000S000000000S000g000t0M000
00000000000000000000t000000000
00000S00S000g00gMM000000000000
00t000S00000000000000000000000
S000000000000000000000000t0000
0000gg00t000000000000000000000
00000000000000000S000S00000M00
00000000000000g00g00S00StB0000
00S00000000000000000S00000000g
S000gt00000000000g0S000M00BB00
S000000000000g0000S000M0000000
