000000000000000T0000000000000G
00S0T0000G00G00000000000000000
0000STS0000000G000000000000000
0000T0000G00G0S000B000000B0000
00000000000GS00000000G000T00B0
0000S00000000G0000000000G00000
00S00000000000000000T0000000G0
000000000000000T00000000000000
000000000000G0T0000S0000000000
000T000000000S0000G000000000G0
0000G0000000000000000000000000
T00000000S000000000000000G0000
000G0G00B000ST000000000B000000
G0000000000000000000T000000G00
000S0S0G000000000T000G0M000000
0000G000T000S0G0000000000000S0
G00000000000000S000T0000000000
0000S0000T00000000000000000000
0000000T000G0000G000000B000S00
T000G0000000G0S000000000000000
0000000000G0S0T00000000000G000
00000000T00S000000000000000000
000000G0000000G000000T00000000
000000S0T00000S0M0000000000000
0000000000000T00000000000S0000
00G0000000G000S000000000S00000
00000T00000000G00000000G00000S
S00S00000000000T0000000M00M00G
000S0000000000000000T000000000
00000000000G0000000000S00G000B
