000000000T000G000000
0ST0S00GG00000000000
000GS0000G0000000000
00000G0000TGS0000000
000S00T00000S0G00000
00000T00000000000G00
0000000000T000000000
000000G0T0000G000000
0S000000S000000000T0
G00000000000G0000T00
GT0G000S000000S00000
000000000GT0000000G0
0000000G0000S0000000
0000T000000000000000
000000000000000TS0G0
0T000S000S0000000000
S0000ST0000000000000
000G0G00S00000000000
000000S0000000T00G0S
0000000SG0000000T0G0
