000000000S000T000000000000S000
00S000S0T00G000000000C00000000
0000000TG000G0000H000000000000
00000000000000000000T000000000
0T00000000G0000000000000G00000
000G000S0000G0000000000H000000
000000000000000000000T00000000
000000T00000000S000S000000000G
0T00000G0000000S00000000000000
0000S0T000G00000000000000S000G
00S000000G000G0000000T00H00000
TG00000000000000000000G0000000
0000G0000000000000000ST00G000H
00GS0000000000G000000H0000000T
0000000000000000000S0000000000
00000G0G000000H000000000000000
0G000000000T000GS000000000000S
000000000000000000T000G0000000
000000G00T0000000000S0G0000000
00000GG000T000000000000000H000
000000S00000000000000000000000
G0000000000000000000000S000000
00000000S000000000000GS0000000
000000000000000G0G00000T000000
0000G000000000000T000000000000
00000S0S000TC000000G0000G00000
0S00000S00T0000000C00000000000
0000000000TS000G00S00000000000
000000000000S0000000T0G00S0000
0000S000000000000000000000S0C0
