000G000000000000000000T0000000
00S000T0000G00000000000000G000
G00S00S000T00G00000000C0H00000
000000000000000000000000S00G00
0000S000000000000000SGT000G000
0S000ST00G00C00000000000000000
0000000G00T0000000000000000000
0000G000T000000000000000000000
00000G00T000S00000000000000000
0000000S00S000TG0000000C000000
000000TS000000000000000000000G
00S0000000G000000T0000GH000000
000G0000000000T000000000000000
0T000000000000000000000000G000
00000G0SS00000T000GH000000C000
0000000000000G000000000T000000
000000G00000000G00000000HT0000
0T000000000G00S000G0000S0H0000
000S0000000000000000000000S000
00000TG0000000000G000000S00000
GST0S0G000000000000000000H0000
00000GS0000000G00T0S0000000000
00000000000000000000000G0TG000
00000000G00000000G0T0000000000
S00000000000000ST00000GC0000G0
T0S0000S000000000C00G00G0H0000
000000000T00000000000000000G00
000S0S00000000000T000000000000
0000000GG00H000T00000000000000
GS000000000000000000000000G000
