00000000000000S000000000000000
000000G0000000000000G000000000
00000000ST000000000S0000000000
00S000G0000000T0000S00C0000000
0000T00000000000000000G0000000
000000S000000G000000T00000000G
00000S000S0G0000000T000G00000H
0000000000T0000000000000000S00
000S00G000000000000000T000000S
000000000000000000000G0000GH00
000000000S00T000000G00000000S0
000000000S00S0C00000000G0000GH
G000G000000000SS0H0000T0000000
0T0000000GG0000H0000000000S000
G0G000000000T000000000H0000000
000000000000000S0S000C00000000
00T0000000000000000000000G0000
0000G0000000G00S00S00000000000
0T0G0000000000000SS00000000000
T00000000000000000000000G000S0
000T0SG000G0000000S00000000000
0000000000000000000S0000000S00
00000S000000000000T00000000000
00G000000G00000000000000SH0000
00000000T00000000S0G0S00000000
G00000000000000T00000G00000000
00000SGS0C0000000G00000000T000
00T0000000S000000000S000000000
00000000S000GG000T0000000H0000
S00000000000000000000000TS0000
