00S0000G00000000000G0B000000S0
000T000000G00000000S00S0000000
00G00S0T0SM0000M00000000000000
0G00S000000000S0000000000000M0
0000000000000000S0000000T00000
000T0000G0000G0000000000S00000
00000S0S00000000000M0000000000
G00000000000000000000000GS00B0
0000G00000000000G00T0000000000
00000S00T0000000S0M0000000000M
000000G000000S0S000000000000G0
0000G0000000000000S0S000000T00
G00000000S00000000T00000S00000
00S000000000000000000G000G0000
0000G00000GB0S000S000000T00000
00000T00G000G0000S000000000000
S0000T000000G00000000000S00000
00G0000S00000000TG000000000000
00SG0000S0000000M0000000000T00
0000000000G00000S00000T0000000
000000000000G0000G0000000T000S
000STG00S000000000000000000000
G000000G000000B000T00000000000
000G000TG0000000000S0000000000
00000000000000000T000000000000
000000G0000T000000000G000S0000
00000000000T0000000000G0G00000
0S0000000T00000000SG0M000M00G0
0000000G0G000000000BT000000000
000000000000000T0G000000000000
