000000S000000000000000g0000000
000000000000000000S0g0S0M00M00
00g0S0g00000000000000000000000
S000000000000g00000000000t00S0
00000000000000000S00S00M000000
00g000000000S0S000gt0000000000
000S0S000t0000g00000M00000M000
00000S0000000000000000000000t0
0000000000t00000000S0000000000
000000000S000g00tg000000B00000
0S000000t000000S0000000g000000
0t0000000000000000g00000000000
000S000000000000000S0t00000000
00t00000000000000g00S000000000
000t0g00000000000000000000g000
000000g00000g000000000B0000000
00S000g00000St0000000000000000
000000g00000000000000000000000
SS00000000000t000000000000000g
0000000g000000000000t000000000
0tg000000000000000000000000000
0000000S00000g00000000S0000000
00t000S000S0000000000g0000MMg0
0000t00S00000gg00000000S000000
t00000000000000S00000000000000
0000t00S0000000000g000000g0000
0000000S0000000000000t00000000
00g00000000g00000000000t000000
00000000000t00000Sg000S0000000
00000000000t000000S0g0g0000000
