0S0000S00000000T00C00000000000
00000G00000000000T000000S00000
00000000000S00T0000000000G0000
G00S0000G000000000000000S0T000
0000000000000000S000000000GGT0
00000000000SG0T00S000000000000
SS000000000000T000000000000000
0GS0000000000G00000000000T0H00
000000GSG0000000H0000S00000000
0000000000000000000000000T000G
00000000000000G000S000000S00C0
0ST000S0000C00000000000G000000
0000000S000000GT0000S000000000
00G00000000000000S000000000S00
000000000000S0000000S00000000G
0000T0S00000000000000000000000
0000S000000000000000G000S00G00
00000T0000G00000000000000000S0
T0G0G00000SS000000000H00000000
0000000000T0SS00000C0000000000
0000000G000T0000000000S00G0000
00000000G00000S0000000T0000000
000000000G000000G0S0000000000T
00T00000000000SG0000000000S000
0000T0000000000000000000S00000
0G0000000000000000S00S00000000
00000000000S000000000000000000
000G0T00S000000000000000000GS0
S000000G000G0000000000000H0000
00000S000000000000000000S00C00
