S0000000t000000000S00000000000
000000S0000S000000000000000000
t00000g00000000000000000000000
0000000000000000g00S000g000B00
S0000000000000S0g0000000000tM0
0000t000000S000000000000000000
gS0000t000g00000000S000000000B
000000000000gg0000000000S0t000
00000000000000t000000S00S000g0
0000000S000S00M0M000t0000g0000
000g0000000t000000000000000000
0000S0000000000S0t000g00000000
0000t00000g0g000B00000000000B0
00000000gt00000000000S000000g0
S00t0S00000g00000g00000M000000
0000000000S0000000t00000000000
S00000000000S000M0g000g0M0000t
000000000g0000000g00000000000S
00000000000t00g00000000000SS00
00000t00g0S0000000g00000000000
000t00000000000000000000000g00
0g0t0000000000g00000000B000000
0000000000gS000000g000t0000000
S0000S0000M000000000000000M00t
0000000000t0000000g00000000000
000000000000000000000000000000
0000000000S000000t000000000000
000000S0S000000000000000t00000
0000000000000S00000000000S0000
000000g00000g00000000000000000
