00T0S000000000000000000000GS00
0000G00G000T000000000000000000
000000000000000000S0000G000T00
00000000000G000000000000000S00
000000T0000000G0000G00000S0000
0000000000G0000000G0000H00THH0
0000T0000G000000000000000000G0
00000000000000T000000000000000
0S000T0000000000000000G0000000
S000G0000000000000000000SG0000
0G00000000000S0G00H00000000000
G000000000000000000S00000G0000
00000000T0000G00S00S00000C0000
T0000000000000000000000S000000
0000000000000000000000000000T0
00000T000S00000000000000000000
G000T0000S00000000000000000000
00000000000000000T00000000G000
0000G0000000S0000TG00000000000
00000000S000SC00000000000G0000
00000000000G000000G0000000S0T0
0000000000G00S000T00000000S000
000000G0000000T000000000S00000
00000000000000T0000S0000000000
0000S0000000000G000000G00000T0
0G0000S000000000S00000T0000000
00000000T00G00000000G0000000H0
S000G0000000000T000G0000000000
S0000000G000000000S00T00000000
00000000GT0000SG0000000000000H
