00000000000S000000000G00G00000
S00G0T0000G0000000000000000000
0000000000G00000000T000S000000
000T0000000000000000G00000000S
00000S000000000000000G000T0000
000000T00000000000000000000S00
000000000000000S00T00000000000
000000S00T000S0000000000000000
00000000000G000000000000000000
00000G00000S00S0C00T00000000G0
00S000000T00S00000000000000000
000T000G0000000G00000000H00000
SS00T00000000000000000C0000000
00T00000S00G00S00C00G000000000
0000000G00000S000000000S000G00
G0S00000000000000SC000000000T0
000000G0T0000000S000000000S000
0000000TG0000000000000000GSH00
0G00000G0000H0000000000000000T
0000G0000000000000000000000000
000000G000000TS00000000000G0S0
GG0ST0000000000000000000000000
00000T0000000G00S0000S00G00C00
0000000000G000000S000000000000
0T0000S00000S000000000000G0000
00000000000000000G0S0000000000
000000G00000000G00000000000H00
000000000000000000000S0000000S
00SS000C000G0000000000G0000000
00000000S00ST000000000G0000000
