000000gg000B0000000000000B0000
0000000000g000g000B00000S000t0
00000g00t00000gB00000000000000
0000g0000000t00000000000000g00
0000000000000000S0000S00t00000
0000000000000t0000000000000000
00000g00000St000S0000000000000
0000000000g00t000000000g000B00
000S0000S000000M000000t00M0000
000000gt0000000000000000000000
0000000000S000000S0000t0M0M000
0000000g000000000000S0S0000M0g
g00S0000t00000000000S000000000
0000000000000g00S0000S00t00Mg0
000g0000g0000000S00000S0000t00
0000t00S000000000000000g000000
00t000000000000S00000Sg0000000
0S0000g00000S000000M0000000000
000000S000000S0t00000000000000
0000000000000000gt00000000g0B0
00g000000000000g0S00B000000000
000000000000000000000g00000000
000000000000000000S0000000g000
000000000gg00000000S00000000S0
0t0000Sg00g000000000S0M0000000
g000g000St00000000000000000000
00000S00000000000000g000t00000
000t00S000000g0000000000000000
0000000t00000000000000000g0000
0000000g0t00000g00000B000B0S00
