0ST0000000000000000G0SG000M000
00000S00000G00000T0G0B00000S00
T00000000GG0B000000000000S0000
000000000S000000000G00000T0G00
0000G0S0000000T0000000000000S0
000S0T000000000000000000000000
G000000T0000000000000000G00000
0000000000SSTM0000000000000000
T000000000000S000G0000S0000000
0000000G000000S00S00GB0TB00000
00000T00000000G000000000SS0000
T0000G000GS0000B0000000000B000
0000GS00000000S000000M0000000M
T0000S000000S00000000000000000
0000G00000000S000S00000000000M
000T0000000000000000000G000000
000000000000000000000000000T00
0000000000G00000G00000TB000000
000T0000000000G000000000000G00
0000000G0000000000T0SG00000SM0
000000000000000000000T0000G000
00TS00S000000000000G0000000000
0000000000ST000000000000000000
000G0T000000000000000000000000
00G0000000G0000000000000SB0000
00G00000000000000000G0S0SM0000
0000G00000TG00000S000000000000
00000000T000000000000000000000
0000G0000000000000000000000000
T0000G00000000S00000000000G000
