00000g0000t0000S0S000000000000
00g00tS000g00000000000S0000000
000000000000t00000000000000000
00000000g000000000000000t00g00
00000000St0000S000000000g00000
0t00000000000g00000000g0000000
00000t0000g00000000g0000000S00
000000000000000S0000000000t000
000S00000000000000t00000000SM0
t0000g000S0000000000000S000gMM
00000000S00000000g000000000t0g
00S000t000g0000S00000000000000
00000000000000000000g00000t000
00000000000000000t000000000000
00g000g00000000000SB0S00000000
0tS000000000g000000000g00000S0
0000t000000000000g000000000g00
00000000000g0S0t00S00000g000B0
00000000000g000t0g000000000B00
0S000S000g0000t000000000000M0g
0t0000000000000000000000000000
g000000S000g000t00000B000B000B
0000t0S000000g00000000g0000000
00000000000000000000S000000000
0000000t000000Sg000000000000g0
g0S000000000g000B0000S0000BB00
St00000000g0000000000000000g00
0000S0000000g000000000g0000S00
0000000000000S000000t000000000
00000S00t00S000000000000000g00
