00000T00000S00000000000000S000
00G0T0G000000S0000000S000C0000
S000S0000000T00000000000000000
000000000000S0S00000000CG00000
000T00000000000000000000000000
0000000000000000000T0000G00000
T00S000000G00S000000000000000G
00000000000000S000T00000000000
00S000000000000000000000T0000G
0000000000G0000000000000000000
000000000000000T0000S000000000
0000G0000000S0000000S0000TGC00
00S0TS0C000000G000000000000000
000000000000000T00000S00000000
0000T0000G00000000000000000000
0000000T0000000000000S00000000
0G000000S0T00S00000C0000000000
000G0000000000000000000S000000
0GST00000S00000000C00000000000
0000000G0T0G0000H0000000000000
0T00SG0S00000C000G00000H000000
00000000000000000000000000G000
0000000000000S0000000000G00000
0000000000000T000S000000S00000
00000000000G0000000SS000000000
0000G00000000000S0T00000000S00
000S0G00000T00000000S000000000
0000000000S00S0TG00C000000G000
0G0S00S000T0000CG000000000H000
G0000000000T00000000G0H0000SS0
