000000T00000000000000000000000
0000000000000T00G00G00S00SC000
0000G00000000T0000000000000000
00000000000S0000000000000S0000
G000T000G000000H000000000000S0
0000S00000000000000G000SG0H000
00TG00000000000000000S00000000
000S0000S00000G00TG00000000000
0000S0000T0G00000000000000S00G
00T000S00000000000S00000000000
00000T000000000000000000000000
000000S000G00000000000000G0000
000G00G000000000000000000H000T
G000T000000000000000000S00G000
00000000000000G0T00000000000G0
0S00000000000000000000000000GT
0000S000000000G000000000000S00
000T000000000S000000000000G0G0
T0000G00000000000000000000000S
000000S0000000S00000000000000G
00000000G0000G0T00000000000000
G0000000000000T000000000000000
0000000000ST0G000000000G000000
000000000000000000000000SG000G
0T0000000000000000000000000000
0000000S000T000S0000G00000000G
000000000000S0GS00000G00000H00
0G000S000T00000000000000000000
S0000000S00GC000000000000000T0
0000000000000S0000S00000T00C00
