00S000S00000000000000G00000000
00000000000000000000000000000S
00000000000000000000000000000T
00000G00000000T0S0000000000000
00G00000000G00000000T000000000
000000000T000000S0000000000000
0G000000000000000GSH0T00000000
0000S000S00G00000000000G0000H0
000000T00G0000000000S000000G00
0G0000000000S00G00000H00000T00
0000000000T0000000000000000000
0000TS0000000000S0C00000000000
0S0000000000S00C00000000000000
00000000T00000G000G00H00000000
S000G000000000000T00000000000S
00000G00000G00000000S0TS0000H0
000000000000000000000S0G000000
000000000G0000000000SS000C000G
0000000000000000000S000S00000T
00000000000G000000000000G0H000
000000000000000G000000S000GT0H
0S0000000000T00000000S00000000
S000G0S00000000000000000000000
0T00000000G00S0000S0000G0000H0
00T00G00000000G00000000000000H
000000G00000000000SG000000000S
00000000000000GS00000000000000
0GT000000000000000000000G00000
0000G000000000000T000000000000
0000000S0000000000000000G0T000
