0000SS000C0G000GT0000000000000
00000000000000T000000000000000
00000000000000000000G00G00T000
0S000T00000000000000S00G000000
000G000ST00S000000000C00000000
000GT0S0G0000000000S0000000000
00T0000000GG000S00000000000000
00000000000000000T000000000000
000G00000000000000G00S0000000H
0000S00G0000000GSH0C00T0000000
000000000G000000T0000000GH0000
G0000000S00G0000H00T0000000000
000000000T00000000000000000G00
00000000T000000000000000000G00
G00000000000TG0000H00000000000
000000S0G00T00000000000G000000
000000S0GG0000000000S000000T0C
0000S000G000000T00G00000000S00
0000S0000SC000000000T00G000000
00000000T000000G0S000GS0C00000
00000T00GG0H000000000000000S00
0000T00000G00000S0000000000000
00000000000T000000000000000G00
0T0000000000000G00G000000S00S0
0000000000000000S0000000000000
0S0000T0000S00000000C0000G0000
0G0000000000000000G00S0000T000
000000GG000000000T00000000S000
00000000000000S000000000T0000G
0000000G00G0000000000000SS0T00
