00000000000T000000000000000000
G000G00000000000000H0H000TS000
00000T00000000000000000000GS00
00G0T000000000000000000000000S
000000T00000000000S0000S000000
000000000G00T00000000000000000
0T00000000000000000000000G0000
000000000T0000000000G00G000000
00000000S000000000000000000000
00000000000000000000GG000T0000
00000T000000000000S000000000SG
00000000000000000000000000S000
0T000000000000S000000S00000000
00SS0C0000C0G00000CT0C00C0G000
000000000000000000TS0G00SC0000
0000000T0000000000000000000000
00G00000TG000000000000H0000S0H
0T000000000G0000G000000000000H
0000GT0000S000000000000000S000
G0000T000S0000000S000000000000
S00000G0S0000T0000000000000000
00G00000000G00S0T000000000000S
00T00000000000000000G0000G0000
000000000000000G00S000000TG000
000000000S0000000S000T00000000
000000000000STG00SC00000000C00
S00000000000S0000000000000G000
0000T0000S00000000000000000000
00G0000S00SG000000T0000C000000
0000000000000000S00G000T0G0H0H
