000S00000000000000000000000000
00g000t0000000000000g000000000
00000000S0000000g0g00000BBB000
000SS0t00000M0000g000000000000
00000000000000000S0000000000S0
g00000000000000t00000000gS0000
S0S00000M00000000000000000000t
0S0g0t0gB00000000000B000000000
00000000St00000000000g000S00g0
00t00000000S0000S000000000000M
00000000g000000t00000000000000
S0000g000S000g0000000BB0tM0000
g00000S00S00000000000g00000MB0
000gg0000000000000tB00000S0000
0S0000S00000000t000M0000000000
g0g000000t0000000000000B000000
000000000000000000000S000S0000
000000000S000000000gt00g000000
000000000000000000000t00000000
00SS000000M00000Mg0g0000000000
000000000gS00000000000g0000000
0000000000000t0000g00000000S00
0000000t00Sg0000000000S00000M0
0000g000S0000000000000000S0000
000t00000000000000000000000g00
00g00000000000g0000000000t0000
0000000000000t000S000gS0000000
000g0000000S0tg000000S00000000
00000000000000000S000000000000
0000000g0000000000000t00000000
