S0T000000G0000000000
0000S0000S000G000000
TG00S000000000000000
0S00G000G0T000000000
0000000T000S00000S00
0000000GT00000S00000
00000T0G000S00000000
0T000000S00000000G00
000S00G00000000S0000
G00T000000000000S000
TG00000000000S000S00
00000TG0G0000000000S
00000S000GG0000S0000
00G00000S00TG00000S0
000000000000000000S0
00000ST000000G0GS000
00SS0000000000T00000
000000000TG000000000
00T0000000000000S000
000000S0S00000000000
