0t00000000000g0000000000000000
000000000000g00000t00000000000
0000t0000000000000000000000000
S000t000000g00000000S000000000
00g000t000000000000S00S0000000
000000g0000000000000000t000000
000St0000000g00000000000g00S00
0000S0000g000000000g000BB00000
00000000000000S0000000000000g0
0S000000000t000000000000000S00
000000000S00000000gg00t0000000
000000g000000g0B00000000B0B000
000000000000gg0000BS0000000000
000S00000000000000000S00t00000
000g0000000S00000000000S0000M0
0S0000000000000t00000000g0000S
0g000tg00000000000000000000000
0000000t00000000000000S0000000
000t000S0000g00g00000BB0000000
0S0gg000000S000000000000t00000
0000t0000000000000000000000000
000SgtS0M0g0000000000MM0000000
0000000000g0S00S00000MM0000t00
000000g0S000St0000000M000M0M00
000g0g00t0000000B0000000000000
00000000000000000SS0M00t000000
0000000000000g0t000000000000g0
0g00g0000t000B00000S0000000000
000000000000000000000g00000000
000g0000000000000t000000000000
