000G000T00G000000000
0T00000000000000000S
0000T000000GSG000000
00000000000GT0000000
00G00000S0SG00000000
0000000000T0S0000000
00S0SG0000T000000000
0G000S00S00000000000
G0T0G000000000S00000
0SG0000T0G00000S0000
00000G0G0S0T00000000
TG0000000S000G0S0000
G000S00000ST00000000
000G00000TG0000000S0
0T000000G00S00000000
0000000G0T0000000000
0000T0000000000G00S0
00000S000T0000000G00
00ST000G000000000G00
0000000G000000GT0S00
