G0000S0000SG00000T00
T000000000G000S0S000
000000000S00000000S0
0000G0GT000000000000
T00000S00000000S0G00
0S000T000GS000000000
0G000000S0000000G000
0000000G0S0000000T00
000T000G000G00000000
000TG00GS0000000S000
000000000GT00000G000
0S0000S000G00T0G0000
000000T0000000000000
0000GS000G0000000000
00000000000GS00G000S
0S0T0S0000G000G00000
STS000000G0000000000
000000000T000SG00000
0T000000000S0S000000
T0G000S0S00000000000
