0000000000000000000000G0S000S0
S0000S000C000000000T0000000000
00000000000000000T000000000000
00G0G00000H00S0000T00000000000
00G00000T000000G00000000H00000
0000S0G000T0000000000000000000
0000000G00000S0000G00000000000
0S00000000000G00000T0000000000
000000T00000000000000000000000
0000000000GS0G00000000SH000000
000S0G00000000G00HHT0H0S000000
00000000S0000G0S0000GC000T0C00
000000000T000000000000000000G0
00000T00000000000000000000G0G0
0TG000G00S0000000000000000H000
0000000000T0000000000000000000
000000T00000000000GS0000000SG0
T0G0000S00S0000G000000HC00H000
000000000000000T00000000000000
0S00000T0000G00000000S00000000
000000ST00G00000S00000000G00H0
G00G00000S00000S000000000H0000
000000S00000000000G0S000000G00
000000T000000G0000000000S00000
000000000S0G0000000000000G0000
00G00000S0000000000S00000000G0
SG0S000000000000G00000H0TC0000
00000TS000000G000G00000S000000
00S000T000000000000S000000000C
00000S000000000000T00000000000
