00000T00000000000000000000S000
00000000TGS0000000000000000000
000000000T0000000000000S000G00
000000G00000000000T000000000S0
0S000000000000000S000000000000
S000TG000000000000S00000000000
0000000000S0000000000000000G00
GG00T0000000000000000000000000
000G0G00000T0H0000000000000S00
000S00000000000S000000000G0000
00S000S000000000G0000000T0C000
0000000S00S0000TG0000000000000
00000000S000S000G00000000000C0
0000000G0000S00G00000S0000000H
00000000T00S00G00000G0000000H0
000000000000000000000000000S0G
000T00000000G00G00S000000000H0
000S000T000000G000000000000SG0
000000S0000G0000000000000000T0
000000G000000000G00H0000000000
00000000T000S0000GG000000000S0
S000000000000T000000G000S00000
0T0G00S00000000S00000000000000
00000S0000000000G00S0G00C00T0H
00SG0S00G0000T000000000000000C
0000G000000G000000T00000000000
GG000000S00S00000C000000000000
000G00TS0000000S0000000G000000
0000T000000000000G000000G00000
000000G0000T00000G000000000000
