00000S0000t0000000000000000000
000000000000g000000000000S0000
00000000000t0S0000000000000000
0000000000g000t00000000g00B000
0000000000000t0000000000000000
t000S000000g000g00000000B00000
0t0000000000000000000000000000
0t0000000000000000000000000g00
0000000000000000000000t0000000
0SS000000M0g000000g0M00B000B00
g0g0000S0000000000000000000000
0000g00g000tSS0000MM0000000000
0000000000000g0000000000000000
0S000000g0000SM000000000000000
Sg0S0000M000M0g000000000000M00
0S0000000t00000000000S0000000M
000g000000S0S00000000000000g00
0000000000000g000S000000g00B0t
0000000000S0SM000000000Mt00000
00000000g000000000000000t0g0S0
00t000000000g00000000000000000
00t000000000000000000g00000000
000000t0000000S000000000000000
00000000000000000S0000000tg000
000t0S00000000000000000000000S
000g0t0000000000000000gB000000
000000000000000S00000gS0t00000
tS000g0000000gB0000000B0000000
g000000000000000t0g00000000000
t000000S00000g0000g00000000000
