000000000000T00000000000000000
0S00000T00000000S000C000000000
0000S0000000T0S000000000000000
S000T0000G00000000000000000000
0S0000T00S00000000000000CG0000
0000000000T0000000000000000000
00SS00G000000000000T0000G00000
GSTG00000000H00000000000000000
00000000S000000000000TG0S00C0G
T0000G000000000000000000G00S00
0S00000GG00T00000000000000S000
000000000S00T0G0S0G0H000000000
00S000S00000CT0000G000G00H0000
000000000000G00T00000000000000
00S000S000T0000000000000G00000
00T000S0S0000000000000000G0000
0S000000S000000G00000000000000
00T00000000000000S000G00G000H0
S00000000000000000000000GG00H0
00T000000000000000S00000000000
00000000000000T000000G000000S0
0000000000000000T0000000000000
0000000000S0G0000S00G000TH0000
0T0000000000G00S00000G00000000
00TG000000000000000S0S00C00000
0000000000000000S0000000T0G000
000000000000000000000000T0000S
00000000T0000G000000000000S000
00000000000000T000000000000000
0000S00000000S0000000000000000
