S0T0000000000G00S0000000000000
000000000G0000000S0000S00T0000
000000T0000000S00S00M000M00000
000000000G0S000S00000000T000G0
00000000T00G000000000000000000
00S000S00000000T00000000000000
0G0000T00000000000000000000000
000T000000000000000SS00M000000
0T0000000000000000000000000000
000000000S000G0000S000G0000000
00S000G000000000S0000T0000000G
00000000000000G00000000000S00S
T0000000000000000000G000G0000S
T000G00000000000000S0000000000
00000000000S0000G0T000000GS000
0SS000000MM000000000T000000000
000000000G00T000000G0000000000
000000000000T00S00000000000G00
000000TS00000000G00000G0000SM0
00T000G00000000000000000000000
00000G0000000000000ST000000S00
T000000GS00S0G0000000000000000
0000000000000T0000G00000000000
0000G00S0000000000000000000000
00000000000000G0T000G000000000
00000000000000S000000000T00000
00000T0S000S00M00GG00000M00000
0000000000000T0000000000000000
00000000S000S000G000G0000T0000
G00000000000000000000S000000SM
