000g00000000000000000g00000B00
00S0000000g00g00t00S0000000000
000000000000000000S0000000S000
00000S00000000000g000000000000
000000000000000S0000t00S000000
g000000000000g0000000000000000
g0000000000000000000000t0S0000
000000000000000g000t0000000000
0000g000gB000000000B000t000000
00t000000000000000000000000g00
0000S000000000S000000000000000
000t00000000000000000000000000
000000t0000S000000000000000000
t00000000000000000000000000000
0000000g0g000000000S000BB00000
0g00000000000000S0t000gB000000
0gg0000t00000000000000B0000000
00t000000000000000S0g000000000
000gt0000S00000000000000000000
00000g0000000000000g00000t0000
gt00000g0000S00000000S00000000
00t00000gS000000g000B000000000
0000000000000000S000S000000000
0000000000000000000000000S000t
00000t000S0000000000000S000000
t0S0S00g0000M00000000000000000
000000000000t0000000000gg00000
0000000t0g000000g000SS00000000
0000000g000000000000000SS00t0g
0000t0000S00g000000gS00000000M
