000000000t00g00000000000g00000
0000gg00000t0B0000000000000000
00000tS0000000000g0g000000SB00
000t00000000000S0S00M00000M000
000S00000000t000000g000000000g
00000g00000000000000000000000S
0t0000000g000g00000000000S0000
0000000000S000g00000000S000M0g
000t000000000g0000000000g00000
000t00000000000000000000000000
0g0000000000000000000000t00000
00t00000g000g0000000BB000000B0
00t000000000000000000000000g00
00Sg000000000000000g0S00000000
00S000000000000000000000000Sgt
00000t000000000000000000000000
t0000000000000000000000000g000
000t0S0000S00000000000000000M0
00000g00000g000000000000t00000
S000000000000000t000S000g00000
00g000S000000000t0g00000000000
000000S0000000000000S00000g000
S00000S00000M0000000000t000000
0000000000t000000000000g0000g0
0g0000000000000000S00g0000S0M0
00S0000gg0000000000000B0000000
0t000000gg0000000000000BB00S00
0000S000S000000000t00g00000000
00000SS0000M0000000000000000tg
00000000000000000000000gt00000
