00000000000S00G0000000000S000C
00000T00000G00000000000S000000
G0000000T0G000000H000000S00000
0G00G00000000000000000000T0000
G0000000000000000T00000000G00H
00T000000000000000S00000000000
000000000T0000000000S00000000G
0000000000S00000000000000000G0
000000G0T000000G00000000000000
00000T000000G000G0000000000000
00000000000000000S0000000G0000
0000000T000S000000000000000000
000000000000000S00000S000000C0
G000000000000000G00T0H00000000
T000000000000000000G0000000000
0G000000000G000000S0000000H000
G000ST000000000S00000000000000
000000S0000T000000000000000000
000G00T00000S00000000000000000
00000T000000000000000000000SS0
0000000000GG000H00000ST0000000
000S000000S0G000C000000C000CT0
G000S0000000000000000T0G000000
00000000S000ST0000000000000000
000000000S00000000T00000S00C00
0G000ST0SC00000000000000000000
00S000000000T00000000000000000
0000000S000000G00000000S000000
000000000000000G000G0000000000
00000000G00000ST0000000000G0H0
