000000000000000G00000000000000
0000000000T00S00000000G00G000B
000000000000000000G000000S0000
0000000000000000S00SM000000000
00000000000000000000T00G000000
000000000000000T00000000000000
0000G00000000000S0000000000000
0000000000G0000000000ST0000000
0G0000000T000000000000000S0000
000000000000000G00000T00000000
0S0000S0M000000G0M00T000000000
000000000000TS00000G000000S000
00000000S000S00G0000000000G000
00000S00T0000000S00G00000G0000
0T0000000000000000000S00000S0M
000S00000000000000S00000000000
0000000S00000S000000000M000M0T
T0000G000000S00S000000M0G00000
0000000000T00S00000000S0000000
S00000000T0000G0S0000000000000
000000000000000000000000000000
00G0TG00000000B000000000000000
0000000000000000000S000S0GT000
TG0S00000000G0000S000000000000
00000000000G0S000000GS0B00T000
00000000000000S0000000T0S00000
00T000000000000000000000000000
S00000G0G00000B0S0000000000000
S00S0000000M000M0T000G00000000
00000T000000000000000000000000
