00000000T00G0000G00BS000000000
G0000T0G0000000S00000000000000
0T0S00G0000000000000000000S000
000000000G0000000S00S000000000
T00000000000000S0000000G000000
0000S0000000000000000ST0000M00
00G00S0000000000000000000000GT
00000G00000000S00000000000G00B
0000000000G00G0T000000B0000000
T0000000G000000000G0B00000B0B0
000S00S0000GT00000000000000000
0000000G0T000000S0000000000000
0T00S0000000000000000000000000
000T00000G000000000000S00000S0
000000S0G000G0000000T000000000
000000000000000G000000G000B000
00000T00000000000G000000000000
000000T0S0SM0000000M0000000000
000000000000000T00000S00000000
00SG000T0000000000000000000000
G000000S00000000000000000000T0
000G00G00000000000000000S00000
G0000G000000S000S0000B0000M00M
S000G0000S00T0G000B000000M0000
000000000000000G000000000000G0
000000G0000G000000000000000BT0
0S0000000000G000000000T0000000
00000000000S00000000000000GTS0
0000S00000G0000000000000000000
000G00T00000000000000000000000
