00g0t0000000000000000000000000
0t0S00000000000000000000000000
00000g0g000000000B000000000B00
g000000000000S0000000000000000
000g00000000000g0B000000000t00
0000000000t00000000000g0000000
0000000t0000000S000S000M000000
000000t00000g00000000000000000
00000t0g0S000000g000000B000000
t000000000S0000S000000M0000000
0000S00000gg00000t00000S000000
0000000g0000g000000B00B0000t00
000t0000g00000000000000S000000
00t0000g0000g00000000000S000S0
000t00g00S0000000000000SM00000
00000000000g00g0000000t0B0000B
0000g000S0000000S0000g0000t0M0
00000000000S000000000000000SM0
00t0000000gg0000S0000000000000
000S000000000000t000000000S000
00000000000g00000t000000g00000
0000000g00gt000000000S0000000S
0000S00000t0000000000000g00000
00g00000000000000g00t00000000B
000t0000000000000000000g000000
0000000t000000000000000g000000
0t0000000000000000gg000000B000
0000000000t00S0000000000000000
00000000S000000000000000000000
00000000S000000000000000000SM0
