000ST000S00C0000000000000000C0
000000GT0000000S0S000000000000
0G00000000G00S0S00000T000C00C0
00000TG000G00H0000000000000000
000000S0000000000000000000T000
0000000G00S0000T0S00000G0H0000
0G0000G000000000T0000000000H00
00000000000S000T0S000000000000
G0G0000000000H0000000000000000
00000000000S00000000000000000T
0000000S000T0S0C000000000000C0
0000TS00000G00000S00G000000000
0000T0000000000S0000000S0000G0
0000000S0000T0000000000S000000
T0000000000000000000000S0000G0
00000000S00S00000000C0CTC00000
0000000S000000G0000G000000H000
0000000000000000000G0000000000
000G000SG000000000000S00000000
T000S000G00000000000000G0000S0
0G000000000000S0S00000000000T0
000000S00000T0G000000000000000
000000T00S0000000S00G000000000
0000G00G000000S000000000000000
0G00000000T00000S000G000000000
000000000000000T00000S000GG000
000T000G0000000000000000S00000
S000000T000G000000000S0000000C
000T0000000000000G000000G00000
00S0000000000000S00000C0TC00C0
