0tS000g0000000000000g00S000000
00S0000000000000000000S0000000
000000t0g000000g0000000000000B
0000t000g000000000000000S00000
0t000000S0g000000000000000S000
0000000g00t00000000g0B00000000
S0000000000tg00000000000S00g00
0000000000S000t000000000000g00
S00000St00000M000g000000000g0M
0g000000000000000g000tB0000000
000g00000000000000000000000t00
00000g00g0000St00S0000B00000B0
000g00000St00000000g0000000000
000000000000000t00000S00g00000
0S000000gg0000000t00000000S000
000000000t000S0000000g00000000
0000g000t00g00BS0B0S0000000000
00S00000000000000g0000000gSt00
S00000000000S0000000000Mt00000
0000000000gS000000000000000gS0
0000000000000000000S0000000000
00000000000t00000000g000g00000
g00000g0000S00B0000000t0000000
000000000S00tS000gM0000000000g
0g000000g000000B000B0000000000
0t0000000000000S0000000000g000
00g00tg000000000B00000000B0000
00S0t0000000000S0000000000000M
000000000000t0S000000000000g00
g0g000000000000BtB000S00000000
