g0000000000000000000000S000000
0000000S0000000000000g00000000
0000000t000000000000g00S0000g0
0000t000000S0000000SM000000000
000000g00000t00000000000000000
000000000g0S000t0g000000000000
t000S000S0000g00000000000000M0
000St000000000S00000M000g00000
00000000000000g000000000000000
0000000000000000000g00t0S00000
0000000g0gS000B00000000000S000
000SS00M000gg00000000000B00t00
000S0000S000M0M0000000M000M00g
0000tgS00000000000000000000000
00000000000000t0000000000000g0
g0000g000000000000000000000SB0
000t00000000000S00000000S00000
0000000g0000g0000B00000B000B0S
000000S00000000t0S00M0000g000M
0000000000000t0S00000000000000
g0000t00000000000000SS00000000
0000000000g0000000000000000000
00S0000000000g0000000000000g00
t0000S0g000000000000000g000000
000000000t0000000000g00gB00000
000t00000000000000000000000000
0t0000g0000g0000000000B000000B
00000S00t0Sg00000gM0M000000000
00000000g000t0000000000000g000
g00000000000000000000000000000
