000000G00SSM000000000000000000
000T00000G00000000000000000000
000000G0000TS0000000000S00000G
00000G00T000000S000000000G0B00
0000000000S00000000000S000T000
00G000000S00000000SM0G00000000
00000S00000000000000000000GT0G
00G00S0S00G0000000B00000T00000
0000000000000000SG0000000S000M
0000000S0000000000000000000000
0000000000000000G000T000000000
00000G0000S0T000000G0B0000S000
0G00000000000S0000000000T00000
000000SSM000000000000M000000G0
0S0G00T00000000000000000000000
0000ST00000000S000000000000000
0000000G00000000000S0000000000
00000000000000000TS00000000G00
0S00000000GT0000SG000000000000
0S000000S0000M000GG00000000000
00000000000000000000000G0T000G
00000000000000S0S000000000T000
000G000G000000000000000000000B
000G000000000000000000000GS000
0000000000G00SS000GT0000000000
000000000000000000S00T000G0000
0ST000000000000000000G000000G0
T00000G00000000000000000000000
00T0000000S00S0000000000G0000G
00T000S000000000S00G000000000G
