000000000000T00000000000000000
T00000S000000S00C0000000000000
000S00G000000GH0S000000T000000
S00000T00000S000000000000G0000
000000G00T00G00000000S0H000000
000000000000000000000000000000
00000000000000000T00S000000000
000S000S00000T0000000000000000
00000000000000000000G000000000
00SG0000T0000S00000G0000000000
00S00G0000000S000G00H000000000
00000G000000000000000S0000000S
0000000S0000000S00GC000000000G
0T0000000000G000000S0000000000
00000000000000S0000G0S0000C00T
T0000000000000000000000000000S
0T00000000000000000S0000000S00
00S0S0000000000000000C000000T0
00G0T0000GH000000000000000S000
0TG0S00000G00000000000000H0000
T00G000000000S000000G000000000
0000T0S0000S00C00G000000000000
0000000000T0000000000000000000
00000000000000S00S000000000000
00G00000000000000G00S00000T000
G0000T00000000000000S000000000
T000000000S000000000000G0000G0
000000000S000G00000S00000T0000
000000000000T00000000000000G00
0TG0G0000000H0000000000S000000
