00G00000S000T00S000G
T00000000000S000S000
S000T000000000S0GG00
000SG00000000S000000
000S000G000000S00000
G0G000T0000000000000
00000000000000000G00
00000G000G0000000S00
0000S0S00G00000000T0
000000T0G0S00G0000S0
SS0G00000000T0G00000
S00S0G0G000000000T00
G00000G0000000S00000
0T0S0000G0S000000000
00T00000000000000000
G0G0000000S0000000S0
0S00000000000000S000
0000T00000000G00G000
S000G0G0S00000000000
000T0000000000000000
