000G0000000GT0000000H000000000
000S00G000S00C0000000000000000
0000000000000G0000000G0THS000S
0000000S000S0000000T000G0G0H00
T0000000000000000000000000000S
000S00000000000000G00000G00000
000000S0000000000S000000000000
000000000S000T0000000000000000
00000T00S00G0000000S0000G0000C
0000G00GH00S000000T0000S000000
0000S0000000000S0T000G00000000
00000S00000000G0000G0H00000T00
0000000000000000G00GH00T000000
G000000000000G0000000000H0S000
000000000000SG0S00C0G000000000
0G000000000T000G0H000000000000
0000000000000S0000000000T00000
0000G00000000000S0000000000000
000T00000000000S0GG000S0000000
000T00000000000000000000000000
0T000G00000000000S000000000000
0000S0000000000S0000000G000T00
000S00000000T00000000G00000000
000000T0S0000000G0000000000000
000000T00GG00H0000000000000000
000000000000000000G0T00000000S
T0000000000000000000000G000000
G000S00T0000S00000000000G0000H
00000S0000S00C00000T0000000000
000000000000T00000000S00000000
