S00000S00000000G000000000T0000
00000ST00000000000000000000000
0SS000000000G00G00H00C0000000H
T000000S00000000000S0000000000
00000S0000000000000000000S0000
000000000000000000GT000000G000
000000S00000T00000000000G00000
00000000G00T000000000000000000
0000S000000000000S0000000C000T
0000000000000000000TS000000000
0S0T000000000000000S0000000000
00000000000000S0TSGC0000000000
000000000000000000S0T000000000
000SG00G0000000S000CH0000000TH
000G0000000000SS000000C0T00000
S000000000000000000000000000T0
000000000000000S000ST000000000
0000T000000000000000000000S0S0
0G0000000T00S000000000G0000000
0T000G0000000G0H00000H0S000000
000G000000S00000S0000T00000CG0
000000000S00000000000000T00000
S00000T00000000000000000000000
0000T00000G00GS000000000000000
0000S00000000000G0000000000000
000000G0SS00000000000000000000
0000T00000GG000000000000000000
0000000000GS0000000T00G0H0000H
000000T00000G00000G0H000000S0S
0000000G0G000S00000000ST000000
