00000000tg0000g0B000B0000S0000
00000000000g000000000000000t00
0000S0000000S000g000g000000000
00000t0000000000S0000000000000
00000S000000000S00000000000000
000000S0tg0000000000000S000000
000000000S0000t000000SM0000000
000000000t00000000000000000000
0000t000gS000000000000000000gS
000S0000000t000000000000000000
0S000000St0000000M00000g000000
00000000000000g00000000000g00B
000S00S00MM00t0000000M0000000g
0gt00000000000000000000000g000
000000000000SS0000t00000000000
000S000gg00000000000t000000000
0000g0t000gS00B00B00000000000B
0000000gt0000S000g000000000000
0g000000g00000000000000t000000
0000000000g0000t0g000000000000
t00000000000000S00000000000000
t0g000000000000000000000000000
000t0000000000S000000000000000
00t000S00000000S00000000000000
000g000S0g00000000000000BS0000
0g0t0000S0000S0000M00g000000B0
0000000000g00000000000000S0000
S0g000000000000000000000000000
00t0000000000000g0000000000000
000000000000000000gg0000St0000
