00G000TS00000G000000
0000000T000000G00000
000T000G0G0000000000
000T000000G000S00000
00S0000000000TG00000
00G00000TG0000000000
S000SG0T000000000000
000S0S00G0G000000000
G0000G00000000000000
00000000T00000000000
000000ST0000S0000000
0000T000000000S000S0
G00000G00S0T00000000
00000S000000S00TG000
0G00000S0S0000000000
000T0000000000000000
0000000S000000ST0000
000000S0SGG0000T0000
0GG000S000ST00000000
000000T0000000000000
