00G0S0000S000000000000C0000000
0S00000000SC000000000000000G00
00000000000000S00000T0000S0000
000SG000000S00G00000T00000C000
00000G00G000000S0T000000000000
0000000000000000000000000T0000
00G000GS000T000000000000H00000
G00000TG0HS000000000000000000S
000T00000000000S0000G0G0000000
000S000000000T0000000000000000
0000T000G0S00000000000G0000000
0000000G0000000000000000000000
00T0000S0000G00G00S00000000000
0000000000000000T000000G00000G
000000000T0000GS00000000000000
000000000000000000000000000000
0000S00000T000S0G0000000000000
00000G0000000000000000T000000S
0GT000000000000000000000000000
G00000T00000G000000000H0000000
0G00000000G000000S000000000000
000S0000000S0T000000000000000G
0000000G000G000000HS0000000000
000T00000000000S00000S00000000
T000000G00000G0H00000000000000
000000S00000000G00000000000000
00S00000000000000S00000T000000
00T000000G0S000000000000000000
0000000T0000000000000000000000
S000S0GT00000000000G000H000000
