0000000S0ST00G0C00000000000000
00T00000000S000000000S000000C0
0000ST000000000000000G00000000
0000000000000000000000000G0000
0000G0T0000000000000S000000000
00000000000000000S000000000000
000GT000000GH0000000000000000S
000T0000000000G000000000000000
0000000000000000000000G000000G
000T0G0000000000000000S00G0H00
T0000000000000000000SGG0000000
T000000000000000000000000000G0
00T0G0000000000000000000000000
0SST00000000000000000G000000GC
0000000000G0000T00000000G00H00
00000G000G0T0000000000000000H0
0G0000000T0000GH000000S0000000
000000000000000000000000G000T0
00000S0000S0000000T0000C0000GG
000T000S00000G00000S0G00000H00
000000S000000T0S0000000000C000
0000000S0000000T000000000S0000
00000000000G00000G0S0H000S0000
000T00G0G00000H00000000000000S
000G000G00000000H000000S000000
000G0S000000000T0000000000000S
00000S00G0000000000000T0000000
0S0S0C0000000000000G0000000TG0
00S0S0T0C000000000000000000000
0000G0000G0000000000000HSST000
