000000T00000000000000000000000
00000T0000000000000S0000000000
000000000G000000000S00000G0000
000G00000000000000T00G00000000
00000T000000000000000000000000
T00000G0000000000G0000S0S00000
000000TS000S000000000000000000
00000000000T0000000000000S00S0
0000000000000G00000T000000G000
T00000000S00000000G00000000S00
TGS00000S000000000000000000000
00G0000T0000000G00000000000000
ST0G00000000000000000000000000
0000000000000000000S0000S0000C
0T0000000000000000G00GS0000H00
000000000G00000000000000000000
000000000000000G00TG0000000S00
000SG000T00000000000G000S00000
000S00000000000T00000000000000
000000000000S000S000000C000000
000000G00G0000000S000000HS00CT
0000000000S0000000000S000000G0
0S0G00000000000000S00000000000
000000000ST0000000000000000000
00000000000S0SG00CT00000000000
GG000000000S000000000S0T00000H
0000000000000000000000000000G0
000000ST00000G0000000S00000000
00S000000T00000000000000000000
000000000000000000S00000000000
