0000000S00000000T00000000000S0
000G00000000000000000000000000
00000000000000000000000000000T
000000000000000000000000000000
0000S00G0S00C000G000H000000000
000000000000000000TG0000000000
0000000000000S00000S0000000000
00G000S00000000000000000000000
00000000000S000000000S0C00T0G0
000G000TG0000S0H000000000S0000
00000G000G000000000000HS000000
00G0000000S00000T00000000S0000
000000T0000000000000G000000000
0T0000G000000G000HS00000000000
000G00000TS00G00000000S0000000
00G000000000000STS00000000000G
000000T00000000000000000000000
0000T000S000000G00000G00000000
000T000000000000000S0000000000
000000000SS000000T000000000000
000000000000000G0S0000000G0S00
0000G00G0H00000000000S0S000000
0000000000000000G0S00000GS000C
0000000T000000G0000000S00G0000
000000000000G000000S0000000000
000000S00000G00000000000000000
00S00000000000S000000000000000
000S00000T0G000000000000000000
000000000G0000G0000TH000000000
00T000000G0S00000000000SC00000
