00000S0000000S0M00G00000000000
000000000S00000000000S00000000
00000T000000000000000000000000
0000000000000000000000000TS000
00T0000000000G00000000000S0S00
00G0000S0000000000000000000000
000S000000000000000SM0000M00M0
T00000000G0000000S00000S000000
000G0G0000000S00000B00S00M00TM
0T00G0000S00000000000S0G0B00B0
0000000T0S00000000S00000000M00
00000S00G00000000000000000000S
T000000G00000G000S000000000000
G0000000G000000000000000B00000
000000T0000000000000G00000G000
000G000T000000000000000000000G
0T0G00000000G000S0000000B00000
S000000S000T000000000000000000
00S0000000G0000TG00000S000000B
000000S000G0000000000000G00B00
0000000T000000S0000G00000000S0
0S0G0000000000000000000S000G0M
0000000000000000T000000G000000
000G000000000000000000G0B00000
00S0000G000S000000000G000M0000
00S0000000S000G000T000000000M0
00000G0G0000B000S0B0TS00M0000B
0GG00000000000B00T0000000S0000
0000S0T0000G00000S000000000000
00000000000S0S000000000T000G0M
