0000000000000T00000S
000G0T0G00S00000S000
00T00000000000S000G0
000S0T00000G000000G0
0G0T0S0000000000S000
000000S0000TG0G00S00
000T00000000G000000S
000S0000000T00000S0G
00G000000000000T0000
000000STG0S000000000
0000T000000S0000000G
000000T0000000000000
0000G000000000T0000G
G0000S0G000000S00000
0G000SS000G00T000000
000000S0T000000S0000
T000000000S0G00G00S0
0000TSG0G0S000000000
000000S0S00T0000G000
GST0S000G00000000000
