0S0000T00000000S00000G00000000
0000000000000000T0000G00000000
000000000S00000GSCT00000000000
000000000GT0G000000000H0000000
0000TS0G0000G00000S00000000000
0T0000000000000S00000000000000
0000000000000T00000000S00000S0
00G0G000000000HT00000000000HH0
000T0000000S000G0000000000G000
0S0000000S000C000000T000000000
00G0000000TSG00000S00000C000H0
000000S00S0000G000000000C0000T
000000S00000T0000000000G0000S0
00T000000000SS0G00000000000000
00S000000000G0000000000S0000C0
00000000T00S00000G000000000000
000000000S0000G0000000000000T0
0000S0000S0C00000000T0000G0000
0000000G00000000000000G0000000
00000000G000T00000000000000000
000G000000000000G0000000000000
0000G0000000000000000000000T00
000G000T000000000000000G000000
000000000000G000000000000T0000
00S00T000000000000000000G00000
S000000T00000000000000G0000000
000000T00000000000S00000000000
0000G000000000S000000000T00000
00000T0000000000G00000G0000H00
00000ST0000000000000000000S000
