0000000T0000000G0S0S0000000000
000000T000000000000000000000S0
0000000G00000000T00000000000S0
000G00G000000T00000000000000S0
00T00000S00000000S00C000000000
00000000000TG0G0000000000SH0S0
000000S00S000000000000000T0000
000T0000000G000S0G0000S00000C0
0000000000000S000000000G0SC000
000000S0000000G000G000H000T000
000S00000000000T00000000000000
000000000000GG0000000T000H0000
00S0000G000000G0H0S000C000T000
0000ST000000000000000000000000
0GG00T00H000S00000000000000000
0000000000000S0000000000G00G0T
00000T00000S00GG000000S0000000
000S000G0000S00T0C0000000G0000
0000SG000T0000000000000000000G
0000G0000000T000000G0S0SH00000
G000000000000000T0G000000000H0
000000000000000000000000000000
000000000000000000000G00000000
00000000000S0T000000000G00000S
0000S0G00000G0000H000T00000000
S00000G00G00000H000000000T0000
S000GG000000000000000000000000
0000000000G00G0000000000000000
00000000T00000S00000S00C0000G0
00000000000000000000S0000T0000
