00SS0T00000000000000
000000G0000000000000
000SG000000000S0T000
0000SS0G00T000000000
00G0S0000000TS000000
000TG000000000000G00
000000000T000000S000
000000T000S0G0G00S00
000T0000000000SG0000
00000000G000G000T000
0G000GS000T000000000
000000S0G000000S0000
00S0S00000GT00000000
000000000000G0000S00
00000000G00T00000000
0000000000000G000000
T0GS0S00000G00000000
00G0G0S000T000000000
0T000000000000000000
GG0S000000000000S000
