00000G0000000000000TS000000000
000000000000000G000000TG000000
000000G0000000G0B0B00000000000
00S0000S000T00000G000000000000
00000000000G00000000000000000T
S00000GTS0000000M000M000000000
000000000000000000000S00000000
000S00000000T000000S0000000000
0000000G00S0T0000000000000G000
0000G000000T000SS000G000000000
000G00000000000000000S0000000T
00G000S000000000T0000000000G00
00G0T0000S000000S000000000000M
00G000G000T00000000B0000000B00
000TS00000000S000G00000000MM00
00000G0000000GT0000000B00000B0
000000000000000000G0000GB00000
000000000S0S000000000000M000T0
00G00T000000S00000000000000G00
000000GS0S0M00000000000G000000
00000G000000000000000000000000
000G000000000000000T00SS000000
00000000T000000000GS0G000000B0
0000T0SG0000000000G00000000000
T0000000000000000000000G00G00S
00000000000S000S0000G00000M000
S000000000G000T00000000000000G
000G0000T000000000000000000SS0
0TS000S0000M000000000000000000
T00000SS000G000MM0000000000000
