00000000000000000000000000S000
000000000000000GT0S00000000000
0S000000G00000000T0000G0000000
00000G0S0T0000G0H0000000000000
G00000000000000T000000S000000S
00T0000GSS0000C000000000000000
G00T0S00G0H00000000000S0000000
0TG00000000000000S000000000000
GG0H000000000T00S0000000000000
S0000S0000T0000C0000000G000000
G000G0000000T00S0000000000S000
000000G000000000000G000S0H0T00
0G0000S00S00C00T00000000000000
00000G0S00S00000G000000000C0HT
0000S00000000000000000T0000000
GS0000000SC0000000000000000000
0G00000000000000000T000G000000
00G0T00G000000000000S00000000S
00000000S00S00000G00000000TC00
00G0T000000000GH00000000000000
00000000000000000000000G0T0000
0G000000000G00000H0000T0000S00
000000000000G00000000000G00S00
G0000000S0000000000000S0000000
00000000000T00S000000000000000
000000000000000S000000000S0000
T0G0000000GS0S0H00000000000000
00G000S0G0000000000000000S000C
0000000G0000000S000000000S0000
T0000000000000000000000000S000
