0000000S000000G000T00000000000
0000000000T000000G0000G00000S0
00S000000000000000000000000000
0000000000000T000000000S000000
00000000000G00000000T00000G0S0
000000000000000G00000000SS0000
0000G00000S0S0000GC000000000T0
00000000T000000000000000S0000G
0G0G0000000000000000T000000000
T0000S0000S0000000C00000G00000
00T000000G00G0000S00000000000S
0000000S0000S00000000G0T0C0000
0000000G0S00000000S0CG00000000
00GS00T000G00S00000H0000000000
000000000G00000000000000000000
0T00G0000S0000000000000G000000
0S00000000000000000000S0C0000T
00G000000G00000000000000000000
0000000000G0S00000000000000000
000000000000S0000000000S000C00
0000000S00000000000000000G0000
000000T0000S00G0000000000G0000
00S0000000000000G000000G00T000
0000S0000T00000000000000000000
0G0SS000000000G0000000C0000000
00TG00000000000G00H000000S0000
000S000000T00000000G000S000GH0
000000S0S00C000000000000000T00
00000000000000S0S0000000000000
000000000000000000000000000000
