t000000000S0000000g0g00000000B
0000000000000t0000000000000000
000000000000000000000S00000000
000000000S000000000g0000000000
00S00S00000000tM00000000000000
00000000000000000000000000000S
000t0000g0000S00000Sg00B0000M0
t0000000000000000S0000S00g0000
00g000g0000000S00000000000000S
t000000000000000000000000g0000
S00000000000t00000000000g00000
00g00S00000gt00S00000000M00000
000Sg0000000000g00000000t00000
0t0000000000S00000000000000000
00g0t000S000000000000000000000
0000g00St000000000000000000000
0Sg0t000000g00000S000BM000000B
0000000g00000t000S000S00000000
00Stg0000000000000000000000000
0gS0000t0000000000000000g00000
00000000000000t000000000000000
000000t00000000000000000000g00
0t0000000000000000000g00000000
000000000000t000000000S0000000
000000S0000000t0S00000000g0000
0S000S00000000g00M000000000000
00g00000000gB000t0000000000000
0S00000000S0000000000000000000
0000000t000000S000g00000000000
0000000000g0000000000000000t00
