S00000000000000S0C000000000000
0S0000000000000000G0S0000000G0
00000S00000000000000000000T000
0T0000000000S00000000S0G000000
000S0G00000000000000000S0T0000
00000000T00000000S000000000000
000000000000000T00000000000000
0000T0000000GG000000000H000000
0000G0000000000000000000000000
000000T00000G000000000000GH000
0000000000000S00000G00S0C00000
000000000000T000S0000000000000
00S00000000SC0T000G000000000G0
G0T0000000G00000000000S000S000
00S000000000000000000S0000G000
00000000000G00000000000T000000
00T000000000000000000000000000
0T00000G00000SG00000S000000000
G0S00GTSH000000000000000000000
G0G000HT0000000000000000000000
0S00000000000000T000G000000000
G0GS0000000H00000000S0T00000C0
0000000T0000000G0000000G000000
0000000000G0G00000000000H00000
S0000000000GT00000000000000S00
00000000TG0000G000000000S00000
0TG000000000000000000000000G00
G00000000000000SG0000000000000
0000000S000000TG00G00000S00000
0S0T0000000000000000000000000S
