000000000000SG0000000000S00000
000000000000G0TG0000000000000S
00000G000T00000000S00000000000
0000GG00TH00000000000000000SS0
00S000000000000000000000T00000
000000000S000000S0000000000000
T0000G0000S0000000000S00C000G0
00T0000S0000000000000000000000
000G00000000000S00T00000000S00
GT000000000000S00000S000000000
000000000000GG0000000000000H00
0000000000G000000000000000000G
0G0T00G00000000000000000000000
000G000000000000000000000S0000
0000000000G0T00000000G00000000
000000000S000000000000SC000000
000000S000000000000000000000T0
0000S0000000000000000000000000
00000000T000S00000000000000000
000000000000S0000000S00G0CT000
000000000000SS000000T0G0000000
000000S0000000S0T0000000000C00
G000000S00000000000G00S0000000
00SS00000000000000GG000C000000
00000T000G000000000000S0000000
000000000000S00000000000000000
00000G0000T000S0000000000G0000
000S0G00TS0G000000000000000000
00TG0000S00000S0G000C00000H000
000S0000000S00000000000000G000
