000T00000000000000000000000000
GT00000000S000000000000S0G0000
0000G0S000000G000000T000000H00
000000S0G000T00000G00000000000
000000G00000000000000S00S0T000
00000000000000000000000000S000
0S00G000000GST00000H0000000000
000000000000S0S00000000TG0000C
G00000S00000000S00000000G00000
0000000000S00000000S00C0000T00
000ST00000000SGG000C000H000000
00000000000T000000000000SSG000
G0000S000000G0000000T0S0H00000
000S0000TS0000000000000C000000
G0G0000S0000000000000000000000
00000000T000000S000S0000000000
00GG0HS00000000000T00SC0000000
00000G00G000000000000000000000
00000000000S00S00T0G00G0000000
0000000000000T0000000G00000000
0000000T00S000000S000000G000G0
00000000000000000000S0000000S0
00000S000000000GS000C000000000
000000S00S0000G000G000000T0000
00T00000G000000000000000000000
00000000S00G00000000000000G000
G00G00T000000000000S000H000000
0G0G0S000000S00000000000000000
000T000SS00000000000000GG00000
00G0S00G000000000H0000S00T0000
