00T00G00000000000S00000G00H000
0G0000000T00000G00000000000000
G0000000000000000000G000000000
S00S00T00C0G000000000000C00C00
00000000000000000000000000S000
000000000000000000000000000000
00000T000000000000000000000000
00TGS0000000000G000000000H0000
00000000S00G000000000000GT0000
ST0000GG00000000000000000S0000
T00000000000000000000000000000
0GG000S0000S000H0000T000000000
0000000T00000S0000000000000000
000000000000000S0000000000000T
00G0000T0G0SS0000H000000000000
T0GG0000000H000000000H0000H000
000T0000000000000S00000000GG00
S0G000S000G0H00000TC0000000000
0000000S000S00000000000TG0000C
00000000000000000000000000S000
S0000000000T000000SG00G0C0000H
0000000T0000000S00S00000000000
000000000000000000S00000000000
0000000000T0S00000000000S00000
0000000000000000000000S000G000
00G000G000000000000000000H0000
0000000T0000G0000G000000000000
0GG0HSH00H000000000000T0S00C0C
0000000G000000000000000000000G
000000000000T00000000000000000
