0000000000T000S0000000S0CCG0C0
000000G000000T000000000G000000
00000S0000T0000000000000G00000
GG0000000S0000T0000000000000S0
000000G000G0H00S0000000000000H
0T000G0000G000000000000SS00000
000G000000G0000000000000S000T0
0T0000000000000S000000G0000000
00000000000T00S0000G0000000000
0000000000TG00S000S000000G0000
0000000000000000T00000000000S0
00000S00000000S0C0G000G0HH0000
000000S000G0T0000000000000S000
0G000000S00GH0000000000000S000
000000T00000000000000G000000G0
000000G0000000000G00000H000S0H
0000000000S000G000000000000000
0000000G0000000000SGS000000000
000000000000000000S00G00000000
000G00T0000SS00000C00000000000
000000G0000000000000000000000T
0TS0000G0000000000000000G00000
0000000000000000000G0000T00000
0000000000000000000000000000T0
0T0000000000G00000000S00000S00
0GG0000T000000000000000000S000
00G0000000000000T0000000000000
000000000000000000T0000000000S
00000000G00000000T00000S000000
0000000000G00000T0000000000000
