0000000S0000000SC0G00000000000
0000000000000000000000G0000000
00000000000T00G000000000000000
00ST00000000000000000000000000
0000S000T0000000000000000000S0
0TSGG00000H00000000000000S0000
000G000000S00S0000T000000C0000
0000000000000G00000000000G0000
0000000G000G000000000000000000
000ST00000000000G0000000000000
000S0000000T000S00000000000000
00T000000000000000000000000000
00T000000000G0000G000000000000
0000000000000000S00T00000000S0
00S000000000000000TG00000000G0
0S000000000000G0000000T0000000
0GS0000S00G000000T000000000000
00000000000000T00G00S00000000G
000S0000000000000GT00S0G000000
000000000S0000TG000000000SC0G0
0G00S0000000T00S00000000000000
0T0000G0000000G0000000H0000000
G000000000000000000S000000000S
000000000000000000000T00000S00
00G00T0000000GS00000H000S000H0
0000S00T00000000000SG000000000
0000000000000000000000000G0000
0S0000G0T000000000000000000000
0000000T0S000000S00000000CG000
0000000000S00000S0000C00000000
