00000ST000000000G000
00000000ST0000G0S000
0000000000000000S0G0
00G00TG00000S000S000
0000000000G000S00000
0ST000000G0S00000000
00000G000S000TG0000S
0S0G00000TG000000000
000000000T0000000000
S00000T0G00000000000
0G000000000000000000
0S00T000G00G00000000
0GGT0000000000000000
T00000GS00000000000S
000G000000000G000000
000GG0000000000S0000
000T0G000G0000000000
000S0000G000000S0G00
G00G00000000000T0000
00G000G0000000000000
