0t000000S00000000000S00000000g
0t000g00000000000000gBB0000000
0000g00S000S000t00000000000g00
00t000000000S000000S0000000000
g0000S0000000000000000000t0000
00S0t0000g000000000S0000000000
00000g000000000000000S0gS000t0
000000000000000000000000000000
00S0t0000000g000000000S0000000
t00000000000S000000S000M0M0000
0S0t00000000000000000000000000
0tSg000S00000g0000000B00000000
g000000g000000000S000000000000
0t0000000000000S00000000000000
00tg0000g0000000000000000B0000
000000000000000000000000000000
000000000000000000000000000000
000g00000000000000000gB00B0t00
00g000000g0000S00000BS00000000
000000000000000000g0000000t0g0
00g0000000000g0000S00000000S00
00000000000000g000000000000g00
0t000000000000000000000S000g00
t0000g00000000000S000000S00000
0t000000000S000000S00000000000
000g000t0000000000000000000000
0t0S0gS0M00000000000000000000M
0000S000000000g0000000000g0000
0000t00g00000000g000000S000000
00000S000000S0g000000000000000
