00000000000000GG000000S0T00000
00S00000000000000T000000000000
000000000000000000000T00000000
0G0000T000000000000000000000G0
0000000000G000SSG0000000000000
0G0000T00000000000000000000000
T000000S0000000000000000000000
00S000000T000000000000000S0000
G0SS000000T0000G000000C0000000
0000000000S0000T0000000S00000C
G000000G000T000000000SH0SC0000
0S00000T0000000000000000000000
000TS0G0000SC000000000000G0000
00000S000000000000G0G000000000
000000000000G00S000S000C000000
00000G00000000G000S0S000000000
00000000000000000T000S00000000
0000000000G000000S00G00S00C000
000T000000G0000000000000S00000
T00000000G00G00000000H00000000
0000000000000000000000000SG000
0000000000000000000ST0000000S0
000T0000S000000G0SC00000000000
0TG000000000G00000000000000000
00T0000000000000000G0000000000
0000000T000000000G000000000000
G00T00000000S0G0000000000S0000
00G00000S0S00000000C0000000000
00G000S00000000000000000000000
0000000000000T00000000000G0S00
