00S00000000000S00000t00000M000
00000000g0000gtB00000000S00000
00000000St000000g0000000000000
S0gg0S0000000000B0000000M00000
0000000000000000000000000000t0
S00000g00S00000000000000000000
g00000000S00000000000000g00000
000g0000000000gS00t0000000B000
0000g0000t00S00000000000000000
00000t0000000gS000000000000g00
000S00000t000g000000000S000000
0t00000000000000000g000000000S
00000gtg0000000000000000000000
00000000g00000000000000g000000
00St00000000000000000000000000
0000gg00000000000BS0S00000tMB0
000000000000000000000000S00000
00000000000S0g0tS00000M000000M
000t0g0g0000S0S0B0000000000000
g0000000000g000000t000000B0000
00000000000000t0g00S00g0000000
00S000000g0000000S000000000000
00t00S00S000000000g00000000000
0000g0000S0000000000000t000000
0000S00g0000000g00000000000000
0000000000000000t000000S00000S
0000S00g00000g0000000S00000000
00g000000g00t000000B0000000000
00000000t000Sg000000S000000000
0gSt0000SM0000g00B000M000B00B0
