000000S00000G0T000000000000000
000S000S0000000000000000T00000
0000000000000000000S0000000000
000SS000000G0M00T000000G00000B
G000000000000000G00T0S000000S0
0T000G000000S0000S00000GM00M00
00000000GT00000000000000000000
000000000T0S0G0000000000000000
00000T000000000000S000G00SG000
000000000000000000000000000G00
000S0000T0000G0000000000000G00
0S00000000000000000000T0000000
00000S0000G00000G0000000B0000T
S0000000T000000000000000000S00
00S00000000S00M000G00000000GB0
00000000G00000ST000S0G00000000
000000S00000000G00000000000000
000000T0S00S00G000000M00000M00
0000000GT0000000000000000S0000
0000000000000G000000T000000S00
G00000000000S00000000000000000
0S000000000S0T00000000000G0000
G0SS00G0000000T000000000000000
00T00G000000G000B0B00000000000
0000T00S000000S0000000MM000000
0TG0000S00S0000000000000000000
0000000000000000000G000S000000
0000T0000000000000G000SS00000M
000T000000000G000000000000000S
0000000T0G0000G000B00S0000BB00
