G0T000000000000000000000000000
0G00S000000000S0000000000TG000
000000G000G0000000000000000000
G000000T00000000000000000000G0
T00000S00000000S00G0000C000000
00000000000000G0000G0000SS0000
00000000000000S000000000000T00
GS0000000000000000000000G00000
SG00T00000000000000000000000S0
0000S00000000000000T0000000000
000000S0000S0C000000G000000000
0000000000000G0000000G00S00000
0G00000000T00000000G000S0S0000
0000000000000S000000T0G0000000
0S00000T0000000G00000000000000
0G0000000000T000G0000000000000
0000S000000TG0000G000000000000
000G00SGS0000C00000000000000T0
G000G0000T00000000000000000000
0G000000000000G0000000000000H0
0000000000000000000000000SG0S0
T000G0000000000000000000000000
0000000G00T000000GS00000000000
00000000G00000GT00000000000000
0000000000000000000000G000000S
0000T00000000000000000G00G0000
000S000000000T000000G000000000
00000000000000000000000T000000
0S000000000000000S00C0G0000000
000T00000000G000S00S0G00000000
