00000000G000G00H000ST000000000
0T00G00000S0000000000000000000
00000T0000000000000000000000G0
000000S00S000000G00000000000T0
0000T00000S000000000000S000000
00000000000G0000T000000S000000
000000G00000000000000000000000
00000000S0S0C00G000000000CC000
00000000000000G0S0000000000000
0000000000T000000000000000GG00
G000000G000000000T0000000S0000
000000T00000000000000000000000
00000000T00S000S00G00000000000
00S000000000000000000000000000
0000000000TS0000S0000000000000
000000000000000000000000000000
00000000000000000G0T0000G0H0H0
G0000000000000000G000000H00000
00000000000000000000000G00G0S0
00G0000000S00S00000000C0G00C00
00000000000000000000000S000000
0000000000000000000GS000000000
000000000000000T00000S00000000
000G0000G00000H000000000H00000
00000000000000000T000000000000
00T0000S0000000000000000000000
000000000000TG0000000000S00000
0000000000T0000000000000000000
0S0000G0000T0000G0000000000000
00S0000000T0S0000000000G00C000
