000000T00G0000G000000000000000
G000000000T0000S000G0S00000C00
0T00000000000000000000000000G0
S000T000000000000000G000S00000
0S000000G000S0000000C000000000
0000000000T00000SS000C00000000
0000T0000G0000G00S000000000000
000000T0000000000S00000S00C000
000G000G0000000000S000T0000000
00000000000000000000S000000000
00G00000000S00000G0T0000000000
0G0ST00G000000000000000000000H
000000000S000000T0000000000000
000GS000000G00000000S0000T0000
T0G000000000000000G0S000000000
00000T000000000S00000000000G00
00000T000000000000S000G0000000
S000000000000T0000000000000S00
0000000S00000000T00000000000S0
S0000000000S000000T00000000000
00000000000T0000SS00000G00G000
000000000000S00000T0000GG00000
000000S0000000000000000000TG00
G0000000000T000000000000000000
00000000000000000000000000G000
S0000000000000000S00G00C000000
00000S0000000000000T0000000000
T00000000000000000000000S00000
000000S0000S000000000000000000
000000000S00S0G0000000C0000000
