000GT0000S0000000000
000T000S00000000000S
0000S000000S00000000
00000000GT0000000S0S
0T0000S00S0000G000G0
0S000S0TG0G000000000
00G000S000000S000000
000G00S0000000000G00
000000000000S00000T0
0000000000S00000S000
000000T00G00SS000000
000000S000S000000T00
T000S0G00G0000000000
0G000000SG0000000000
0G0G0000000000000S00
000000000000000G0000
00G00T000G00S0000000
00G00000G000000000T0
S000G000000S000G0000
0T0000G0SS0000000000
