G00000T0G00000000000000S000000
00000000S00000000000S0G00G0000
000000000000SG00000000T0000S00
0T0G0000000000S000000000000000
G000000000000000000000000S0000
ST000G00000000000000SC00000000
T0000000000000000G000000G000H0
00000000000000T0G0000000000000
0T0S00000000000000000000G00000
G00T0000S00S000000000000000C00
T0G000000S0S000000000000000000
00T00000000S0000000000000S0000
00G0T0000000000000000000G00000
000000T00000000000000000S00000
0SG00000000G0000S00000C0000000
000G0000GT000S0000000000000000
00S000000S00000G00000000000000
000000T000000G0000000000000000
000000GT0S00S0000000000000000G
00000000000T0000000S000G0000G0
0S0000000S0000000C000000000000
000000G0G000000H00000000000000
0S000G0000000000000G000000S00T
00000000000000000000000000000T
000000TG000G000000000000H0S000
000000S0G000000000S00000000000
000000GSG0000000000T00H0000000
ST00G00000S00000000000000C0000
000TG000000000000000000S000G00
0TG000G00000000000000000000H00
