0t000000000000S000000g000000gB
S0000t00S000000000000000M000M0
0t00000g0000000g00S0B000S00000
00000t00g0000000000000000Sg000
0S0000000S000t0000000000000000
0t000000gg00S0000S0B0M00000000
0gt000000000g0000000000000000S
000000t00000000S00000000000000
0SS0000000M000000g00000000M000
000000000t00000000000000000000
00t0000000000000000000g0000S0S
000000S000000000000000S0t00000
000000000000000S000g000000000t
00000000000tS00gS0000000000000
0000000000S0S0000000g0000g000B
0000g000000SS000000000M0000000
0t000000g0000S0000000000000S00
000St00000S0g00000000g00000000
0000000000000000t000000S0g0000
00000S000000t00g0000g00000S0M0
00000000000000000000000g000S00
0000000000S000000gS00t000000g0
00g0S0000000gS00M0000000000000
00000000000000g0000000g0000000
0000000t0S000000000000000000g0
00S0S0tM000000000000000g000000
00000g0000g000000000000t000000
00000S000000000gtg0000000S0000
S000000000S0M00000000000M00000
0000t000000g000000000000000g00
