000000t00000000000000000000000
0t000000g00000S0000000S00gMM00
000000000000000t00S0S00000M000
000t0S00000S00M0000M0000000000
00tS0000000000000000000000000g
0000000000g0S0000000t000000000
000000000000000gS000000000t000
00S00000000g0000000000000000S0
g00000t000g000000SS0B00000B000
000000t00000000000S0000000S000
000g000000000000000000000S0000
0g0gt0BS000000000000000S000000
0000000000S0S00000000000000000
000000000g0000g000000000000B00
S00g000S00000000000t0000000000
000000000000000000g000000000t0
00000000000S0000g0t0000g00000B
gt0000000000000000000000000000
000000000000g00000000000SS000M
0000000000S000tS00g00000000000
000000000t000000000000000g00S0
0tS000000000000000000000000000
00g0S00000000000000000g0t00000
0000000S0t0000000g0000g0000000
00000000g000S000g0000t00000000
0g00g0S0000000000000000t000000
0t00000000S00S0000000000000000
gS000g000S0t0M0000000000000000
t000000S000000000000000S00000M
00St00000g000000gS000000M0M000
