0000000G0000000000000000000000
000000GT000000000S00S000000C00
00000000000000S000T0000S000000
00000000S00000000G000T00G00000
000000000G0000S00G00S000C00000
0000000000000000000S00T0S00000
00T0G00000000G000000000000SS00
00T000000000000000000000000000
00000G00000S00000000T000000000
0000000S00S0000000C000C0000000
000000000000T00000000000000000
00000G00S00G0000000000000H0000
000T0000000000000000S000000000
00000000000000000000S000000000
0S000GS0C00G0000H0H0CCH000000C
00000000000S0G0000000000000000
0000000000000T000G0S0000S0C000
000G0S000000000G000THS000000H0
000S00000000000T0000SCC0000000
0000000000000T000S000000000000
00000S000000000000000GG0000H0T
T000000000G0000000000000000S00
G00T000G000000000000000S000000
0SG00S000C0T0000000000000000G0
000S000STC0000000000C000000000
0T0000000000000000000000000S00
00000G00000000000S0G0000000TS0
0000000G0000T00000G0SH0S000C00
0000T0000000000G0000S000000000
00G0000T0000000000000000000G00
