0000G0000T0000000000000000G000
S0000000000S0G00000000000G0000
00000000000000000000000000T000
000000T000000000000000000000G0
GT00000000S0000000000000000000
000000S000S00000000000M00000G0
000S00T0000S00G00000MG00000000
00000G0000G000S0000000B0000B0S
0000000TG00000G00000000000000B
G000G000T000000000000000000000
S000000000000000000000T00G0000
000000T00S00000000000000S00000
000000000000000000T00000000000
000000S000SMM0M000M000T0000000
00G0G0T00000000000000000000000
000000000T00000000000SG0000S00
0000TSG00000S00000000000000000
0000G00000000000G0000000000000
S0000000T00000000S0MG000000000
000T00000000G000S0000000000000
000000GT000000000G00S00S000000
0000G0000000000000000000000000
00S000000000000000000S00000000
000000000T0S000S0000000000000M
T0000G0000G0S0000000000000000S
00000000G00000000000000000G000
00000000000TS00000GG0000S0BMB0
000G0000000000000G00S000000S00
00000000000GT0000000000000G000
00000000000T000000000000000000
