0000G0000000000000000000000000
00000000T000S0000000000S000000
000G000000G0000000000H00H00000
GG00000000000000000S0000000000
0000000000S0S00000G00C00000000
0G000000G00T0H000000S000000000
0000000000000000000000T0000000
0T0S0000000000000S00C000000C00
T00000000000000G00000000000000
000000000000000000000000000000
TS0000000S00000000G0000000000G
000G0000000T000000000000000SG0
0S00000000000000S000C000000000
00S0000000000000000000G0000000
0000000000S00000000000000000S0
000000000T000000G0000000S00000
000S0000G00TS0000000000C000000
000S000000000T00000000S00000C0
00000000S00000SG00000000000000
00T00G0S0000000000000000S00000
T000000000000000000000000S000G
0000G00G0000SH000000000000HH00
000000G00T000000G00S000H000000
00000T0000000000S0000000000000
00T000000000000SG0000000000000
000000000000S00000000000000000
0000000000G000T000000000000S00
0G0000000000000000000000000000
0T000000000000G0S0000S0000C000
0T000000S000000000000S0G0C0000
