S0000G000000000000S0000000000T
S0T000000000G0000000S000000C00
0000000GS0000S0000000G0C0T0000
0000SS000000000G000000000T0000
0000000000S0000000G0S000000000
000GT00000000000000000SG0S000H
00000G0T000000000S00000000000G
GG000S0000000H0T00000000000000
000000000000000GT0000000000000
0000000000T00000000000G0000000
000000T00000000000000000S00000
0000TS00000G0000000000000000S0
000G000G00000000T00S0H00000000
000G0000000G000000S000SHT00000
S00000S00000000000000000000000
000S00000000000000000000000000
00000000000S00000S00000000TC00
0T000000G0000000000000G0000000
000000ST000000000000S000000C00
00000S00SC00000000000000G00000
00000T00000S000S00CG0000000000
00000GS00000S00000C00000000T00
0000000000000G0000G000000S0000
0000000G000000000000000000000S
0S00000T0000000000000000000000
000T00000000000000000000000000
000S0G0000T000000G000000000000
00T000G0000000GH00000000000000
0S00000S00G0000000000000000000
00000000000000000000000G0T0000
