0000000000S00000000G0000000000
00000000000000G000T00000000000
000000000S000000T0000000000000
00T00000S00000000S000000000000
000000000000G0G0S00000T0000000
00000000000000G0SG000000S00000
0000000000GG0000000000BBSB0B00
S0000000000000000000000T0G0000
000000T0000000000000G0000G0S00
000000000000000000S000T0000000
00S000000000000000S00000000000
00000000G0G00000000000S0000000
000000GG0000000T0000000S000000
000S0S0000000000000000000000T0
000000000000000000000T000000G0
000000000000000G0000T00000SS00
TGS000000000G000B0B0B00S0B000M
0000TS00000000G00000S00G0000M0
00000G00000T0000000000G0000000
000000G00000000000000000000000
0T000S000000000000000000000000
00000000000S000TG0000000S00000
00000000000000T0000000000G0000
00G00000000S0G000B00B0000B0000
0T000S00G000000000000000000000
000000000000S00000000S0T000000
00000000G00000000T00S00S00G000
0000G00000000000G0000000000000
S0000000000G000000000000000000
0000000000000000T0000000000000
