00000g00000000000000000000000g
00St000000000S0000000000000000
000t00000000000S00000S0000000g
000S0t000000000000000000S000M0
000000g00t000S000000S000000000
S00SM000000000000000000000000M
00t00000000S0000000000000g0000
000000S00t00S00000000g0000M000
000S00t000SM000000000000g00000
g0t0000000000g0000BB00000B0000
00000000000g000000000t0S00000S
0000t0000000000g00000000000000
S000000000000000000S0000000000
000000000S00000S0000000000t000
00000t000000000000000000g00000
00000t00000S000000S0M0000000g0
00gt0g0000000000000000B0000000
000000g00000000000000000000000
0000St00000000000000000000g000
00t0000000g0000000000000000g00
000000000000000000000000000000
g0000000000gB00B0t000B00000000
S00t00000000000000g000S0000000
St000000000000000000000g0g0000
00000000000S000000000g0gt00000
0000g000000000S000t00000000000
t000S00S00M00M000M0000M0000000
000g0000000000000000S000S00000
00000000000000000S0000St000000
0000t0SS0000000000000M00000000
