00000000000000G0S0000000000000
000000000000T00000G00000000000
G00000000000G000000000S00000T0
00000000S00000S00000000000000G
0000000000T0000000000000000000
00000000000S000000000000000G00
00000000TS000000S0M00000000000
0000T0000000000000000000000000
0G0000000000000G0000000000B0SB
0T0000G00000000000000000000S0S
SS0000M0000000000000M0000TM000
000000000000G000000000000000S0
G00G00000000000T00000000000000
00G0T00000000000000000S0000000
S0000G0000G000000000000000000B
00S000000000000T00000000000000
0000000000000000000T000SS00000
G0T000000S000000G000000S000000
00000SS0000000000G00TGM0000000
000000000000000000000000G000G0
GS0000G0S00000000T000000000000
00T000S0000G00000S000000000M00
0000000000TSG000000000S000G000
0000000S000000000000000T000000
S00000G000000000000000S0000T00
000000T000S000000000000000000G
00000000000S00S0000G000T000000
000000000S00000000000000G00000
000000000T000000000000000000S0
000000000S000S0M000M0000M00000
