0000S00000t00000000g0000S00000
0t0000g00000000000000000000000
00g000000000000000000000t00000
0gt000000000000000000000000000
000000000000000000000000000000
00000000000000000000000000g00g
0000S0000000000000g0000000t000
000000000t00000000000000000000
0g00S0000000000000g00000000000
0000gS0S000000000000000g000000
000g00000000000000000000000000
000000000t0000g00000g00SS00000
000g0S000S0000000000t000000000
00S00000Sgt00000000000M0000000
0000000000t000000000000g000000
g0000000gS000000tB00SB000M000B
tS000g0g00B00000000S00M00000M0
tS0000000000000000000000000000
00000SS0000g00M00g00000000000t
00000gS000t00000000000S0000000
00000000S000g00t00000000000000
0000000000S0000000000000S0g0g0
000000000000g0000000000g0000BB
0000t000000000000g000000000000
0S00000g00000000000000S0g00000
000S00000S0g0000000000000000M0
0000000000000000000000000S0000
g000000t0000000000000000000000
0000000000S0000S0t000gg0000000
0g0000000000S0000000000000000S
