0t00000g00000S00S000000000000g
00000000000000000t000000000000
gS0g0t0000B00000S0000M000B0000
0000S00S00000000g0000t00000000
00000000000000000t0000000g0000
0000000000g000000000000g0B0000
000000000g00000000gS0000t00000
0t00000000000000000000000000S0
000000000000000000000000000t00
000000000000000000000000000t00
0t0000000000000000000000gg0000
g00000000000g000000000000t0000
0000g00000000000t000000000000g
S000S00000000000000t0000000000
00S0S0Mgt00000000000M0000g0000
000S0g0000000S0000g00t00000000
000000000000000t000g0gS0000000
000000000000000000t0000S0000g0
gS000t000000g00000000000S0B000
S0000g0000000000000000S0g0000t
0000000000000000000000000000t0
00t0g0000000000g00BB0000000000
0S0000000000000g00000g00000000
g000000000g00t00000000000B000S
g0000000000t0000000g0000000000
00t00000S00S00000M000000000000
000000t00000000000000000000000
00t000000000000000g00000000000
000t0S0000000g00000S0g000000B0
g000t0000000000000S000S0000000
