S0GSM0000000000G00000000000000
000000T00S00000G0000G000000000
000000000000000S00000S0000T000
0000T000000S000000000000G000S0
00T00000000000000000GS00000000
0000000S0S000000000G0000000000
0000000G00000000000000T0000000
00000000S000000000S00000G00T00
00000000000000S00000000000T000
00000000G00G0S000T000000000000
000S000G0S0000000M0000000000G0
00000TG000000S00000000S0000000
000G0000000000000000000S00G000
00G000ST000000000000000000S000
00000000SGG0000000000T0000000B
0000000000G000G0B0B00T0000S000
000T0000000000000000000S0G0000
00G0000000000S000TS0000000G000
0000000000S000000000G0G0T00000
00000T000000S0000G000G00000000
00T00000G0S00000000000000G0000
000000000000000000T00000000000
0000000000000G0000T00000000G0B
0000000S0G0G0S00000000000T0000
T00000000000000000000000000000
000SS00TMM0G000000000000G00B00
000000000000000000000000000000
00000000T00000000000G00000000S
0G0000T000000000000000G0000000
000000G000000000G0000T0000B000
