000T000000000000000000S0S0000C
00G0000S00000000S00C000G000T00
0000000000000000000S00000000G0
000000000000000000000000000000
000G000000000000000SS0000T0000
00000T000G0000S000000000000000
S0000T0000000000000S0000000000
000T000000000000000G0000000000
00000T0000000000000000S000G000
S0G000G00T0000H0000HH000000000
GS0000000000000000000000000000
S00000T0000000000G0000S0000000
000000000000T00000000S00000000
G0000000000000000000S000T00000
000000GS000000000000S000G000C0
0000000000000000S000000000000T
000G0000G000000000000000000T00
0S0000000S0000000C000000T00000
000000000T00000G00000000000G00
000G00000S0T00000G0000000H0S0H
000S00000T000000S0G0000C000000
00S00STC0G000C00000000000000C0
000000000000000000000000000000
000000000000000000000000000000
00000000S000000000000T0S000000
00000T0000000000G0000000G0H0S0
00000000000T000G00000000000000
000000T00000000000000G00000000
000000000000000000G0000G00H000
000000T000000000S00000S0000000
