00000000T0S000000S000000000000
S00000000T000000000G0000000000
000000000000T000SG0000G00000S0
GG00T0000000000000000000S0000S
000000S00S0000000T0000000G0000
00000000T00000000000S000000000
0000000T0000000000000000SS0000
0000000GT00000000G000000000000
0G0000000000000000000S000000T0
0T0000000000S0000000000000000G
000S00TG00000000GB0000000000B0
0000000000000S0000000TG00000SM
000T0S0000000000000000000S0000
0T00000G0000G000S0B0000000B000
G00T000S000000000000000000000S
G00000000G0000000B00000S000000
00T00SG00000000000G00000000000
00000S00000000T00000000000000G
0T000000S00000000000000000000G
000000T00S000GS00000G0000B000M
00S00000000000000000ST00000000
000G000G00000000ST0000000000B0
0G00000000000000S000000S000000
000000G0000S00000000G0000000S0
S0000000GS000GM00000000B000M00
000000000000000000G000000000GT
0000000S00000000000T0000000000
000T000000000SS0000000GG00000M
000000000G0000G0000000B0000000
00G0000000000000GB000000000000
