00S000000000S00000000000000000
00000000T000000000000000000000
0T0G00000S000000000S00C0000000
00000000000G00000000000G000000
0000T0000000S00000000000000000
00000000T000G000000000000000S0
00000000T00000G000000000000000
00000000000000S000000000000000
00000000000T0G0000000G00000000
0T0000S0000000000GS0000000G000
00ST0000G0S0000G000000000H0000
000T000S00000000000G0000S00000
000T0G0000000000000S0SG0000000
0TG00000000G00000000000S00SC00
00000S0000000000G0G0HS000T00C0
00000S00SG0000C0000000G0000000
000000000000000T00S00000000000
T0000S0G000000000000S0C0000000
S00T00000000000000000S00000000
00000000000S0000000T000S000000
000000T0000000G00000000S00G000
00000000G00000000S0S00000G000H
000000000S000T0000000000000000
0T000S0000000S000000C00000G000
0GS0000000G000000000000000T000
0000T00G0000G00000000000SS00C0
0T0000000G000000000000000GS00S
00G00000G000000000S00000000000
0S0000000T00000G0000S000000000
GT00000S0000G00S00000000000000
