00t0000000S0000000S0g000000000
000000t000S000000000000S000000
0000t000000000000000g000000000
000S00St00g000000M00g000000000
00000000000000000S00g000000000
00g000000000000000000000000t00
0S00t0000000S00g0000g000000000
000000000000g00g00000B00000000
00000S00t00000000000000000gS00
00000SS0g0000000000t0000000000
g0000000t00gB0000000B000000000
000000S00000000000000t00gS000g
000g000000000000000t0000000000
t0g000000000000000000000000000
0000000gS0000gBt00000000B00000
0S000g000g000000B0000000000000
000000000t0000000S00000000000S
0S0000g000000S00000t0000000000
000000000000000g0t000000g00000
0tS000000000000Sg0000000000000
00000t0000000S0S000M0000000M00
00000000000000000000000000t000
00g0000000000t0000000000S00000
00000S0t00000g0000000000g00000
0S0S0000000000000M00000000t000
0000000000000000000000t0g0S000
00000000SS0g00M000000t00g00000
000000t000S000000000S0g0000000
00000000000g000000000000000000
0t0000000000000000000g000000S0
