0T0000000000000000000000000000
00S00000G0000000T000000G000000
000G000000S00T0000000G0S000H00
000T000G00000000000000000000SG
T000000000000000000S00000000G0
00000000T000000000000G00000000
0T00000000000S00G00G0S00000000
T00000000000000000000000000000
000G000000G0000000000H0S00T000
S000T0G0000000S000000000000000
S000000000000000T0000000000000
000000S00G00S00000000000000T00
00000000000G0000T0000000000S00
000000TSG0G00000000000H0000000
00000T00000G0000S0000000000000
00T0000S0000G00G00000000000000
0000000000000S000000000G0G0000
000000000000000G00S00000G0T000
0T00000GS00000000000GS000H0000
0T0000000000000S0000000000000S
00000S00000000S00000000000C0G0
000G0S000S0T0G00000000000000H0
000TG0G00000000000000000000000
000000T000G0000G00000000000000
00000T0000000G00S00000000000G0
000000000000000000000000000000
0S00SC0000000G0000000000000000
0000000T00000GG000000000S00000
0000G0000000000S00TS0000000000
0000S000000000S00000000T000000
