0000000000000t00000g0S00S00000
0000S0000g00000000S000Mg000000
S00000000gg0000000000000000000
00000000000000g000000000000000
S00g000SM000000000000000000000
0g00t0S00000000000000000000000
S000000000tS0000000000M0000000
00gt00000000000000g000B0000B00
00S0000000t0000000000000000g00
00S00000000S0M0t0000000M000000
00000S00000000000000S000g00000
000000000000000000000000000000
000000t0000000000000000S000000
0t00000000000000g0g00000000000
00000S000t00000000000000000000
00t000000000000000000000000000
000S0t000000000000000000000000
t0000000000000000S0000000S0000
0000000g00000000000000000S0g00
Sg0St0000g00000M000000000000M0
g000t000Sg0B000S0B0B0000000000
00S00000gS00000000000000000000
00000t0000gg0BS000000SB0000000
0000000g0000000000000000t00000
00g000000000g000000B00000B0000
0000t00g0000000000000000000000
S00000000Sg00000000M0t00000g0B
000000000g0000000000t00gS00S00
0000000S0000000t00000000000000
0000000t000000000S000000g00000
