00000000000S000000000000000000
00000S000000000000000000000000
G00000000S00S00000G0000000T000
00T0000G0000000G00000000000000
00000000000000G000G000000000HH
0S00000G00000G0000S000H0HC00C0
0000000T00000000000G0000000000
000G000000000000000000T00S000S
S000T00S0000000000000000GC0000
000000000000000G000T0000000000
0000000000000000000000T0000G00
000000000S000000000G0000000000
G0GT00000000H0000000000000000S
000000000000000T0S000G000GS00C
000000G00000T00000000000000000
0SG000G0000H0000000TS00000000C
0T0000000G0000S0000G00000S0000
0T000S0000S0000G000C0000000000
000ST00SG00000000000G000CC0000
0G00T00S0000000000000000S00000
0000000S0000S000000T0000000000
000S0000000000GT0GH00000000000
00T000S00000000000000S0000GG00
0000000000T000S000000000000000
T000000000000000G00000000S000S
00G00SGS0H00CT000C000000000000
00000S0000000000T0S00000000000
0000G0000000G0HS000000000T0000
000T00G00000000S00S00000000000
0T0000G0000G000S00000000000000
