0000000000000000000t0000000000
0000000t0000000000000000000000
Sg0000t00g000S000M000B00000000
00g000000t0000000gB00S000000B0
0S000S000000000000000000000000
00000t000000000000000g00g0000S
00000000S00Sg00000000000M00000
00000t00000000000000S000S0M000
0000000000000gt000000000000g00
00000000000S0000tS000000000000
0000t000000000000g000000000S00
000000000g000gS0000t0000000000
0t0000000000000000000000000000
00000000S00000S000000000t00000
0000S0Sg00000gB000000BBM0000M0
0000000t000000S00000g000g00000
00000S000000000St0000000000000
00g00t00000000000000000000000g
00t00g000000000000000000g00B00
00S000t000000000S000000M00M000
0S00000000gt0000000000000g0000
00000t00000S000000000000000000
0tS0S0g0000M00g00000B0B0000000
000000000000000000000000000000
0000S00000S0000000000000000000
0000000000000000g0000000g0S000
000000000000000000000t00S0SMM0
0t0000000000g000000S0000S00000
000g00000St000000000000S000M0g
00g000S000t00000000Sg000000000
