00000T000000000000000000000000
G000000000000G000000000000T000
000000000000000000000000000000
S00S00000G00000000000T000000C0
0000000000S00S0GT0G0H000000000
0T00000000000000000G0000000000
000T00000000000000000GS0G0000S
000S0000S0T000000000C000000G00
0000S00S0G0000000000000000000C
S0000000000000000T00SG00000G00
0G000000G00S000000000T0000000H
G000000000G00H0000000000000000
0T00G00GS000000000000000000000
G00000000000S0000000000000000G
000000000T0S0G0000000G00000000
00T000000G0G0S00000000H0S00000
00000T00000G0000S000S00C00C000
0000000000000G000000000000000G
0000000G0000000000000000000000
0000000T00000G000S0000000000G0
0G00000S00G0S00000000C00000000
0000000000000000000000000000T0
0000S00S0T0000000000000G000000
000000G00000T00S000000000000S0
0000000000T0000000000000000000
000000000000000000S00000000000
S0000000T000S00000000000G00000
00000T00000G0000000000S0000000
000000T0000000000000000000000S
000T00G00000000S00000000000000
