00000Sgt0000000000SM0000000000
0000000000000000000000g0000000
000tS00000000S000000g000000000
0000000000000000000000000t0000
t0000Sg000S0000g00000000000000
00000g0000000000000S0000000000
00S00t000000g0000000000000000g
000000g00000t0g000000000S000B0
000000000000000000000S000g0000
0000S00SMtg000000000000M000000
000000t00000g000000g000S000S00
000S00S00000g00000t00000000000
00000000000Sg000g0S00t0000B0B0
000t00S000000000000000000000S0
0SS00000tgg000MM00000000000000
00S000S000000tg00000000Mg0000M
00000000000S0g00S0M00000000000
000000000000000S00t0000S000000
000000000000000000000000000S00
00000000000S000000g0000t000000
0000t000S000000000S00000000000
000t000000000g0SS0000000000000
000g000000S00t00g0B00000000000
0t0000S000000000000S0000000000
000000000000t00000g00000000000
00000000t000000000000S0S00g0g0
0000t00000000g000g00000B000000
g00000g00000000000000B0000t000
000000000000000000t000S0000000
0t0S000000g000g00000000S00000M
