0000t00000000000000000000000S0
0000000000000S00000000000t0000
000000t0000000000000000SSM0000
g0000000000000000000000000S000
00000t0000000000000g0000000S00
00000000g0000SS0g00Mt00M000000
0000S0000000000g0000g000t00000
00000t0S00000000g00000000S0000
S00g000t0000000000g000000000S0
000t0000000000000000S000000000
0000000t0000000S000g000000g000
0g00000000000000000000000S0t00
g000000000S000t000000000000000
000000S0g00S00000000000000t000
g000000S00000000000000000t0000
t000000000000000000000000S0000
00000S000000000000000000S000g0
0gS000S0g0000M000t00M00000000B
00000000S0000000g0t0000000S000
Sg000S000gM000000000000000t000
000000000000Sg0t00000000000000
000000000000000St0000000S0000g
00000000g0000000t0000S00000000
0t0000000000000000000000000000
0t0000000000000000000000000000
0g00000000000000000t00g0000000
0000tS0S0000000000000000000000
00000g000000t00000000g00000000
000000000000000000000gt00000S0
0g0S00S000MM0000000000000t0gM0
