000000000000000G000000000T0000
000000G000000000000000S0000000
00000000000G0S00000000000SG000
00000000000000000T000000000000
00G000000000T0000S000000SC0G00
GT0G0000S0000H0000000000000000
000000T0S00000G000000000000000
0000000000000000000T0000000000
000T000000000000000000S000G000
00000S0000000000T000S0GC000000
0000000000000000S00S0G0G000000
0TGG00000000000S00000000000000
000000T000G0000G00000000000000
0T000000000000000000S000000000
000000000000000000000000000000
000000000000G00G00000H000000T0
G0000TS00000S0C000000G00000000
0000000S0000000000000SG0000000
0T0G0000000000G000H00000000000
000000GT0000000000G00000S00000
000G0000T0000000S0000000000000
00T00000000S0000S0C00000000000
00000S00000S000000000C00000000
000T0000000S0000G0000000000000
0000G0G0S0000000T000000000S000
000000TSG00S000000C000G0000000
00000000000S0T0000000000000G0G
000G000000000T0000000G0H000000
00T0S0000000000000000000000000
0G0S000G00S0000C00H00000000000
