0000T0000000000G0G000000000000
000000000000000S0S0M0000000000
000000G000G000000000B000000000
G00S000T0000000000000000000000
000000S0S0000M0000000000000000
G0000G00000000T000B00000000000
0000000000000T0000000000000G00
0000000000000000000000G0000S00
00G00T0000G000B0000000S00S0000
S0T00000G000000000000000000000
000000000000000000000S00T00000
G00T00S0000000000G000S00000000
0000G0000000GB00000000000S0000
T000000G0000000000000000000000
00000000SS0000000000GG0B000000
00000000000000G0000S0000000000
0000G000000000000S0000T0000000
0000T00000000G000000000000G000
000000000TS0000000000000S00000
000G00000000000000G00000000000
SGG000000000000000T000B0000000
0000000000000000T0000000000000
0S00000S0M0T0000G0000M00000000
000G00000S0G000000T000000S00M0
0S0T0000000G0000000000G0000000
0G00G00000B000000000S000SB0000
000000000000S0S0M0M0MGT0000G00
00G0S000000T0000G0000000000S00
T0S0SM000000000000000000000M0G
S0000000000TS0000000000000M000
