G00000000T000S0G0H000000000000
G00S000G00000T000H000000000000
00000000S000000000GG00000000T0
00T0000S0S00C00000000000000000
0T0000S0000000S000000000000000
000000SG0000000T00000000000000
0000000000000000000000T0G00000
0000ST000000000000G00000000000
000000000000000000000000000000
00000000S000000000S000G00G0000
000T000000000000000000S0000000
0000T0000000000000000000000000
S00000000000000000000000STC000
0000000000000000000000000000S0
000000000000GT000G000000000000
G000000G000000000000T000000000
00000000000000G00000S0GS00HT00
0000000000000000G0S0000ST00000
0000T00000000G0000G0H000000000
00000S00000000G00S000000000000
0000000000T0G00000G00000000000
00000G00000000000ST000000000S0
0000G0000000000000000000000GT0
0G00S0000G00000000000000000000
0S00000S00C000000000G000000000
00T000000000S0000000000000G000
0TG000000000000S0G000000000000
00000000000000G0000000S000000G
00G0000S000G0T0000H00000000000
0000000S0GGH0000000000S0000C00
