00T00000000000000SG00000SC0000
T000000000000000G0000000000S00
0000000S0000000000000000000000
000T0000G0000000000000000000S0
0000000000G0000000000000000000
00G00000000S000G0T000H00000000
000000000S00000000000S000000T0
000S00G000T00000000000000000S0
000000G0000G00S000H0000000S000
0G00000000000000000T00000S00S0
0ST00000000G000000000000000000
000T00000000G000000000000G0000
0000000000G0000S0000000000T000
000000000000000000S000S0C00000
000T000000000000000G0000000000
T00000000S00000000000000000000
0000000000000000000000000S0T00
0S000000000000000000G0000000G0
00000000000000000000000000GG00
00S000000000000000000000S00000
0000G00T0000000000000000000000
0GT000000000000000000000000000
000000T00000000000000000000000
000SS0T0000CGG0000000000000000
0000000G00000T00G0000000000000
T0000000GG0000000000S00H000000
0000G000GS000000000S0000000C00
00000T0000000000000000G00000S0
000000T0000000000000G000000GS0
00T0G0000S000SC0G0000000000000
