000TS000000S000000000000000000
0000000S0000000000000000000000
00S0000000TS0000000000000000G0
G00000000T00000G00S0H000000000
000G0000000000S000T0G000000000
S000S0G000000C0000000000000000
0S000000000T000000000000000000
00G00000TS00000G0000000000000H
000S000000000G0000000000G00000
000G000000000000GS000000H00000
0000G000000T000000000000G00H00
00T000000000000G0S000000000000
000T00000000000000000000000000
000000000G0S000000000000T00000
0T00000000000000G0GS00H00000S0
000G00000000000S0000000000T000
0000000000000000T00000000000G0
00T00000000G000000000000000G00
000000000T00000000000000000000
00000000S00000T0000000000000S0
000S0G00000000G000000000000000
00000000STG0000000000000000000
00S00000T0000000S0000000000000
0GT00000000G000000000S000S0000
00T00000000000000G000000000000
000000000T0000000000000000000S
00000000T00SS000C000000G000000
000000000GT0000G000000H0000000
000G00000000000000T00000000000
0000000000000000000G000000G000
