t0g00g00000000000B00000S0000B0
0g0000g0S000000000000000000000
00S000000000000000000000000000
000Sg00000g000S0000000t0M00000
0g00000000000000000000t0000000
00g00000000000g0t0000000000000
000000000000000000000t00000000
0t0S00000000000000000000000000
00000000S0S0000g00000000000000
00S0t0000000000000000000S00000
t000000000000000000S00000000S0
000g000S0t0000000000000000g000
tS0000000000000000000000S00000
S0S0t00000000000000000000000M0
00000t00000000000000000000g000
00g000t00g0S000000000000000000
0000000000000000000S000t00S000
000000000000000000t00000000g00
000S0000000000gS00000000g000B0
0S00S00000000000t000M000000000
00S0t00g0000S00000000000000000
0000000000000000000000g00t0000
000S00S000000M0000000000t0g000
0000t0S0g0S0g0000000000BB00000
00000tg0000000000000000g000000
0000t00000S0000000000000000000
000g00000t00000g0000000000S000
0g0S000t000000000000000000S000
0g00t0000000000000000S00000g00
000S00g00000000g0B000B000000S0
