000T0000000000G00000
S00GS000000000000000
0000000GG000000S00S0
0T00000000000G0000G0
000000G000000S0000G0
00000000000S00S00000
TS000S00000000000000
S0000T000S0000000000
GS00G000000000000000
G0000S00G000T00S0000
000S0SG000000000000G
0000000GS00S00000000
000000G00000000T0000
00000T00000S0000S000
000000GG000000000000
00T0000G0000000G0000
000T00000G000SS00000
00G00T0G000000000000
G0000T0SS0G000000000
000000T00000000G0000
