00G000000SG0T000000H0000000000
00000000G00000000000000000T000
0000000S00000SC00000000000000T
T000G00S000G0000000000S00000H0
00000000000000000G000000000000
000000S0T0000000000000000000S0
00T00000000000000S000000000000
000S000000S00000000000G0000000
00000000000000S00000S0000C0000
S00G0T0000GS00000000H000C00000
000S000T0000G0000000000000S0C0
000G0000SS0000TG00000000000H00
0000000G00T000000000S000000000
00000000000000T0000000000S0000
0T00000000G00000000000S0000000
0000T000S000S00000000000000C0G
00000000000TG0S000S00000000000
G000000000000S0000000G00000000
000000T000000G000000000000S000
0000S0G00T00000000000000000000
S0S0T00G000000GC00C0000H0H0000
00000S00000T000000000000S00000
0000000000S0000S0000000000000T
0000T00000000GS0000000000G0000
0000000S0000G000000SG00000H000
T000000000000G0000000000000SG0
000000000000000G00000000GS0000
0T00000000000G0000000G00000000
0G0000000000000000000000000T00
000000000000000000000S00000T00
