000000T0G00000000000G000000000
000G0G0T00000000000000000H0000
00000T0S0000000S00000000000000
0T0000000000S00000000000G00000
T00000000000000G00000000000000
0000000G00000000G000000T00S000
00TG00000000000000000S00000000
00000G00000000000000000T00000S
G0000000G0000000000H0000000T00
0T00000GG00000000000000H0S0000
00000GT00000000G000000HS00S000
00G0000000TG0000000000000S0SH0
0000000000000G0000000000000000
00000000TS0G000G00H00000000000
0000T0000000000000S00000000000
00000000000G000T000000G000000H
00000G0G0SS000C000000H0000000T
0000000000000G000000000000GS00
GT0000S0000000000000000000S0C0
000000000000000000S0000000G000
0000T0000000000S00000S00000000
S0000T00000000G0000000S0000000
00000G0000000S000G0000S0000000
0000SS000T000C0000G00000G00000
0G00000000000000000000G0T00000
S00S000000000000T0000000000000
00000000T000000000000000000000
0000G0000000000GTH000000000000
T000G0000000000000000000000000
00T0000000000000S0000000000000
