0G0000S0000S00GT0000
00000000000000T00000
00000000T0000G000000
0000000G000S00000000
000G000000000000S000
0000S0000000T00SC000
0SG000S000000000000T
000TG0S0000000S000C0
00000S0S00000000000T
00000000000000000000
0TG000000000000G00S0
G0000000000000000000
00G000000G0000000000
ST0000000G000S00G000
00000000000000G0000T
0000G0S000000T00000S
000S000GT000000S0000
00T00000000G00000SG0
0G0G0000000SS00C0000
00000000000S0000T000
