000tS0000000000000000S00000000
000t0g0000000000g00000S00S000M
0000Sgt0S000g000000000000000M0
0000000000000g0t000000g0000000
000S00000000000t00000000g00000
g00t0000000g0000S0S000000000B0
t000000000000000000000000000g0
0S00t000000000g000000000000000
00S000g0000Sg0M0000000t0000000
00000000tg00S0000000S0M0000000
000S000t00g0000000000000g000B0
000t000000000g00g0000000000000
00000000tg0S0S0000g00000000000
t00S000000S0000000000000000000
000000g000S00S0000000t0000000M
00S00g000gB00000BB0B00000000B0
t000g000g00000B000000000000000
000S0000000gg0000S0000000M0000
00000000g00000t000000000000000
00S00000000000000000S000000g00
00tS00000000000000000000000000
0000000g00g000000000000St00000
0000g0000000Sg000000t000000000
00000SS0000M00tM0000M00000000M
00000000000000000000S000000000
g0g00000S0000000000000000tS00M
000t0000000000g00000000S000000
00000000000000000000g000000000
00000S0S00000000000000000gt00M
S0t0gS0000000000000000000M0000
