S0G000000000T00000G0
T0000000S000000G0000
000000000G0G000T0000
00000000000000S0TS00
00T0G0S00G000000S000
0T0G0S00000000G00000
G00GT00000S000000000
00GS0T00000S00000000
0S00S0T0000000G0G000
T000000G000000000000
T0000000000000000G00
000T00000000S00000G0
0S000T0G0000G0000000
000000T0000G00000000
GGT00000S0S000000000
ST000000000000000000
00G0G000TS0000000S00
T00000000000S00G0000
0000S0000000T0000000
0S0T0G0000G00000S000
