0000000GS00000T000S000G0000000
0000000000000S000T0000000000G0
S00000T0000000S000000000000000
0G00000000000000000000G00T0000
000T00SG00G000000000000000SC00
0000T0000000000000G00000G00000
000000000G0G00S0000T000H0S0000
00000000000G0000T000000S000000
00000000S0000000000S0000000C00
00000000000T00000S000S00000000
000S00000S000G000GCH0000000000
0T0000000000S00000000000000000
T00000G0G000000000000S0000000S
0000000000000000000TS00G000S0G
00S000S00000000000C00000000000
000000000T00000000000000000000
00000GT000000000000000G0000000
0000000T000G000000000000000000
00000S000000000G0000G000S00000
000000000G0000T0SG000H00000000
00000000000000000000T00SS00G00
G000000000000T000000000S000000
S000S0000000000000000GT00G0000
0000000000000000GS000000000000
0000000T000000000000000GG00H00
00000000G000000000000000000G00
S000000T000000000G00000G000000
000000G0000000GS0000000H000000
0000G000S000000000SC0000000000
0000000000000000000000000T0000
