00000SSG0C000000000T
G000S00000G000000000
0000000000T000000000
GS0000G0T00000000000
G00G000000000000T000
000T000SGSC000000000
0S000T00000000000000
S0G0SGC0000000000T00
000G0GS0000S00000C00
000GT00000000S0G0000
TG0S00000000S000C000
0G00T0000G0000000000
S000S00000000C00G000
000000S00S0000000C00
T0000GS0000000000000
00S000000SG000000000
0000000GS00000G00TS0
00G00S0000T000S0C0G0
G0000000000T00000000
0000S00S0000G0G00000
