0S0000T0000000000G00
000000000000000000T0
G000S0000000000000S0
00000000S0000TS00000
0SG00S000000000T0000
0000000S0000GT000000
00000S0000T0000G0000
G000SG00S00000000000
000000000000G000S0T0
G00000000000000000T0
000000S0S0G000000000
00G0T0G000000000000S
00000G00000000000G00
S0S0000000G0T0000000
00S000ST0000000000G0
00000000S000000T0000
000G00000000G000S000
00T00S00000G00000000
0000000G00000S000000
0000000G00T00G000000
