000000S00000000000G0
00GS00000S00000T0000
0GG00000000T00000000
000000000S0000S0T000
0000G0S0T000000000G0
0000S00S00000GT00000
G000000000000000T000
000000G0000000000000
G000GT0000000000000S
0S000SG00000000TG000
0000S00000000G0T0000
0GT0000S00000000S000
000T0000S000G000000S
GS000000S00000000000
S0SG0000000000000000
00000000G00G0S00000T
0000000T000000G00000
0T000G0S0000G00S0000
G000000000T00000000G
0G000000000000000TG0
