00S00000SG00TC000000
S000000000T00G00S000
0000000000000000000T
T0S0000000G0000G0000
00TS000S000000000000
T00G000000000000G000
000000000000S0GG00T0
0000000S00000000T000
0ST0000000000GS0C000
0S00000S00000T00000C
0000T0SG0SC00G000000
00000000T0000G0G0000
00000S00T00G000G0000
00S00000000T00000000
S0000ST000000000000C
00000000T00S00000000
0T00G00000000000S000
T000000000S0S000C000
T0S00000000000000G00
T00000000S00000000S0
