0G00000000000000S0000000000000
000000000000000000000000000T00
000000000T00S00000000000000000
000000T00000000000G0000G000000
000000000000000S0000G000S00GM0
0000T0000000000000000000G00S00
00S00000000G000000000000000000
00000000G00000000S000T0S00G000
G000TS000000000000000000000000
SG000S0G0000000M000000T0000000
000000000000G000G000000000T000
0000000000T0000000000000000000
000000S00S0TM0000000000000M000
000G0T000G00000000B0000B000000
0S0000000G00000000S000000M0M0G
00000000000000T0000000000G0000
0T0000000000000000000000000000
GG000000000000B000S000000S0BB0
0G00S0000000S00T00000M000000M0
000T00000000000000000000000000
00T000S000000G000000G000000000
000000GT00G00B00000000000000B0
00000S0SG0G000000T00MM00000000
00000000000000000G00000TSG0000
00000T000000S000000000000G0000
0000000000000000G000000S000000
0S0TS00000000M0000000000000000
00S000G00000000000000S000G0000
0000000000S0000000T00G00000000
00000000T00000G0000000000GS000
