000000000000000000000S00T00000
000T0000000000S00000000G000000
000000000000000000000000000000
000000000000000T00S0000000000S
GG00000000000000000S0T00000000
000S00000S00000000C00000000000
00000000000S000SG00C000GT00000
0000000000000G000000G000000000
S000000S00C00GC00000000000G000
000G000T0000000000000000000S0G
T00000000000000000000000000S00
T0S000000000G0G00000H00000000S
00000000000G00000000G0000H0000
0000000S00T0S0000C000C0000000C
0000000000000G0T00000000000000
000T00S000000000000000S0000GC0
00000T0000000000000000000S0000
00000000T00000000000G000000000
0T000000000S0000S0000000000000
0000S00S000CC00000000000000T00
0T0S00000000G00000000000000000
0G0000G00S0000000TS00000000000
0000GT0S0000000G000000S0000000
0000T00G0S00000S0G000000000000
S000S0000000000000000000000000
0000000000T0000000000000G00000
0SS00T00000G0000G0000000000000
S00000000000000000000000S0000G
000T000G000GH00S0H0000S0000000
0000000000S000T000000000000000
