g00S000000000t0S00000000000000
0g0000000000000SS0000000000000
000000S0SM00000000000000000000
0g000000000000g0S0tB0000B000BS
0g0S0000000g0B00000000S0000B0M
000000000000000000000000000000
0t00000000000000000000g0000000
0000000S00000000000g000000000S
00000000t0000000000000S000g000
00000000000t000g0gS00000000000
00000000000000g0000S00000S000g
00000gg00t00000000000S00000S0M
g0000g000000000B00000S00000000
g0t000000000000000000000000000
0000g0000000000000000000t00000
000000t00000000000000000000000
0g0000g00000000S00000000000000
S00000g0g000000B00000000000000
0000000000000000000000000gt000
0000000S0000000000S00000000000
0000000000t0000000000000000000
0000g00000000000000000g0000000
00000000S0000g00000g0000000t00
0000000000000g00t0000000S00000
00000000000g0000000000000000t0
0S0000tg000000S0000M0M00000000
00gS000000g000000000000000000S
00S0000000S0000000000M00M00000
0S0000000000000000000000000000
0S0000g000000000S000000M0g0000
