0000T0S0000000000000000000G0G0
T00000000000000000000000000000
000000000000000000000G00T0G000
000G0000000000000S0G000T00000S
0000000GS0000ST00G00000000000M
S00S0000M0000M00000000G00M0000
000000000000000000GT0000000000
00000000S00000000TS0000M0000M0
0000S0000000GS00000000TM0M0000
000000000000000000G0000T000000
T00000GG0000000000000000000000
0000000S000000000000000000T000
0000000000000S00000G0GB00T000S
000G00000GS00000S00000000M000M
00S0000T00S000000000000000000G
00T000000000000000S00000000G00
0S0000G000000000000000S00G00B0
S0G00S000G00M00000MM0000000T0B
0000000GGT00B000000000000000S0
G000000TS000S0000000M000000000
0000G000G000000SBB0000000000B0
00S000T000000G0SG0000000000000
000000000000000000G0000000T000
0000SS00000G0G0B00000000000000
00000000000000T00G000000000000
0S0000000G000T0000000G000B0000
000000000000000G00G000B0000000
000000000000T0000000000G000G00
000G000S00S00000T00M0M0000G000
0000000000G000S0S00M000M000000
