00000000000000g0000000g00S0000
0S000000g000000000000000t000S0
000S00g00000000000000000000000
0S0000000000000t00S00000000000
0g0000000000t000000gB000000000
0000000000000000S0000g0t000000
0g0000S000000000000000000g0000
0t000000000000000000000000g000
000S00t000g00g0000000000000000
t0S0000000000g00000000000S0000
0000000000g0000000000t00000000
000000g00000000000S000000S0tM0
S00000000000000000000000000000
000000000000S0t00S0000Mg00000M
0000gS0000000000g000000t00000B
000g00S0000000000000g000t0000B
0000t00000000S0000000000000000
g000000000000000t0000000000000
00S0000t00000000S00g0000000000
0S0000000000000000000000000000
000000000000000g000000000000t0
0000t00000000000g0000000000000
00t0000000000000000000S0000000
0000t0000000000000000000000000
S00t0g000000000S000000M00g0000
0SS000M0000000g000000000000M00
0t000000g000000000000000000000
0000000gS000g0t00000000S0M00M0
000000000000000S0000St0000g000
t00000000000000000000000000000
