0GG00S00000000000000
000S0S00000000T00000
000G00000000GS000000
0000G00S000T000000SG
00T00G0G000000000000
0G00000T00000000000S
000000GG0000000S0000
00000T00000000000000
000000000GT000G0000S
S00000000S000G000000
00000000G0G00000T000
00000000000000000GG0
TG00000000000G0S0S00
00000S0G000000000T00
00000S00S0000G000000
000000000S000G000S0G
000000T00000G0000000
0000T00000000000S000
00S0S000000000000000
0000000S0TG000000000
