G0000S0T000000000000
S00SC00000T0G00000G0
G00T0000G00000000000
S0000SG0G00000000000
000000T0000000000000
0ST0G0G00S0000000000
000S0S000000C0000000
000000G000000000G000
GTS00000000000000000
000S00G00S0000000T00
0T00G0000S0000000000
0000000000000000000G
00000T000000000S0G00
0000000TG00000G00000
00000T0S000G0G0S00C0
0000000000000G0S0000
00G000000000S0000000
00000ST0S00000000000
00S00000GS00000C0000
00000000000000S000ST
