000000000S000000000S0t00M0000g
S0000S00M000tg000000000g0B0B00
000t0000000g00000000000g000000
00S000g0000t000000000000000000
000000S0000S000g0000t000000000
0000g00000000000S00S0000M00000
00000t0000000000S0000000000000
000000000000000g00000000000000
00000g0000g0t00S0000000B000000
000S0tg0S00g000000000BB000000B
0000000000000S00SMg0g000000000
0000S00000S00t0000g00000000000
000000t0g000000000000000g00000
0000000g00S0t00g00000000000000
S000t0000000000000000000000000
0000000t000000000000000S000000
0t000000000000000000000000000g
00000000St000000S000000000g000
000000000000000000000S000000S0
00000000000g000000Sg0S0BB000B0
000000000g00000000000000000000
g0000g00000000000000000B0t0000
00000g000000000000000000000000
St0000000000gS0000000000000000
00000000S00000000000000000000g
00000000S0000000g0000000t00S00
000S0000000000000000000000S000
0000g000000000000000000000000g
0g0000000g0S00SM00000M00000000
00000S0S0000g0t00000g0000000M0
