00000000t0S0000000000000000000
0000000000t00000000g00S000g000
000000gg000000000000000000000S
0S00000000g0000t000g0BB0000B00
0000000t000S00000000000S0M0000
000g000g00000SB000tB0000000000
0g0S00000g00000000000000000t00
0000000000000000000000t0000000
000000000S000S000M0000000M0000
000S00g0000000000Sg000MM000000
000000g000S0000000000000g00000
00g000000000S00000t00000000000
00000000000000000t0000000000S0
00000000S0000000t00000000000S0
000g0t0000000000000000000S0000
00000t0S00g0000000000S000M0000
0000000000tg0000000000000000S0
0000S0000t000S0000000000000000
00S00gS00000000000t00000000000
000tgS0000000g000000000B000000
00S000tS00000000000000000000M0
0000000S0S00Mg0000000t0000M000
00g0t0g000B00S0000000000000000
t00000000000000S0000000000g000
00000000000t00000S0000g0000000
000000SS00t000g00000000g000000
00000g0000000g00t0000000B0000B
0000SS00000000000000M0000M000t
00t000000000g0S000000000g00000
00000000000000000000000000t000
