0000G0S0T000S000000M0000000000
00000000000000GG00S0S0M00000T0
S00T00S0000000MG00000000000000
0T00GS00000000000SG00000000000
000000S0000G0G0S000000T0000000
000000000000000000S00G00000000
G0000G00000000B00000000000000T
0S000000000T000000000000000000
00000000S00S000000000000000000
00000000000000000GS00000000000
000S0G000000S00000000M0G0T0M00
0000000000000000S0000000S00000
0000TG000000000000G00000B00000
00000000S0000000000000000000S0
G000G0000B00000BS00000000S0000
000000000000000000000000T000S0
000000000000S00000000000S00000
000000000TS0000S00000000000000
000000000S0000T000000000000000
00000000000000000S00000TS00000
S0000T000000000000000000000000
0000000G000000000000000G0T0000
0000S00000TS00000000000000000G
G00G0000000T00S000000000000000
000000T0000S0S0000000000000000
00000000T0000000GG000000000000
00000G0000000GT00B0000000B0000
0S00G00000T000000000G000000000
S00G0000000000S00MG0B0B00T0000
S00000000000000000000000000000
