00000000T000000G0000
000ST00000S000000000
0000TGS00G0000000000
0000000000SGT000G000
T000S00S000000000000
0S000000G00ST00000G0
000000G00S00T0G00000
00GT0S00000000S00000
00S00G000S0000000000
00000000000G00000000
0G0S0ST0000000000000
0000000000S0000S0000
G000SG00000000S00T00
T0000000000G0000S000
0000000000000000G00G
000T0000000000SG0S00
TS000000G00000000000
00000S00000000000000
00T0000000S0000GG000
000S00000GG000000000
