0G00000000000000S000000000000G
000000000G00G0T000000000000000
000T00000000G00000000000000000
000GGH000000000000000000000000
00000000000000000S0GG00H000000
0000000G0T00000000000000G0S000
G00000000000S00000T000000G0000
000000G0000000000000T000000000
S000000T0000000000000000000000
SST0G000000C000000000000000000
000T0000000000000000000000G000
0G0000000000G0000000H000000000
0S0S000000000GT0GC0000000000H0
0G0G0S0H000000S000000000000000
0000000000000000S0T0000000000S
000GT0000000000000000000000000
0000000S0000000000GS0C0000000T
G00000G000T00H0000000000000000
000TS0000000000S00000000000000
000000000000000T000000G0G00000
0T00S00000000G0S000G0000000000
00T000G00000000000000000S00S00
0000000G00T00000000000S00000G0
0S0S00000G00C000000T0000000000
00G00T0G000S0000H0000000000000
000000000S0000T000000000000000
0SG0T000000000S0000C0000000000
00000000T0000S0000000000S00000
00000ST000000000000G00000S0000
G0GS000000000S0H0000C000000000
