0000T00000000000000S00000000G0
0000000SS0T0000C00000000000000
00000T000000000000000000000000
000G00000T000000G0000000000000
000000T0GG000S0000000000000000
0T00000SS0G00G00000000000000H0
000000000000000000S00000000000
0000000000000T0000G00000000000
000000000T00000000000000000000
00000000000000000S0000G0000000
00000000000000GT00000000000000
0S0000000000S0C000G0000T000000
S00000T000000000000000000S0000
00000000000T0000000000000S0000
0000000T0000000000000000000000
GS0G000000000S0000C00000000000
000000000000S0000SC0G000000000
00S0000000000000000S0000CG0000
T00000000000G0000000000000S0S0
000000G00S00000T00G000S0000000
000T0000000000G00000000S000000
T0000S0000000S000000000G000000
0T00000G000000000000000G000000
G0000000000000000000000S000000
0000000GG00T00000H000000000000
000000T00000000S000000G0000000
000000000G00000000000000000000
00000GS0000GT00000000S00000000
S0T0S0000000000C000000000G0000
S00T0000G0G0H0000000S00000C000
