000000S0000TS00000G000000C0000
T000SS00000000000000000000C000
0000000GT000G000000SH000000000
00S000000000000G00000000000000
000G000S0000T00G000000000H0000
000000T0000000000S000000000S00
00T0000000000000S0000000S00000
00S00S000000T00C0G000000G00000
000000G00000000000000G00000000
000G00SG000000S0T0000000000000
G0000000000T00S00G00S000000000
0000G000000000S000000000SG0H00
000G0S0S00T00000C0000000000000
000000000000000G00000000000000
0000000ST0000G000000G00000000H
000000000000T000000000G0000000
000G000000000G0000000T00000000
0S0000S0000000000000T00G00G0C0
0000G0000000000G00T0000S000S0C
000000000000000G0000000S000000
000000S0G00000000T0000000S0000
00000000000000000ST00000000000
00000000000000000GG00000000000
00T000000S0SC00000000000000000
T00G0000G0000H0000000000000000
0000000000000SG000000000000000
00000T0000S0000000000S0C00000G
0GS0000S0000G000000000000T0000
00S000000T000G000G0000000S0000
0GT0G00000H0000000000000000SS0
