0000000G0000T00000000000000000
00000000000000000000G000GH0000
T0000000000000000000000000000G
000000T00G0000000G0S0000000000
000000G0000000000G000000H00000
00000ST0000S0000G0000000000000
000000000S00000000000000000000
0000000000000000000S0000000000
000G0000000T00000000GS00000000
00000G000000000S00000000000000
000000000S00T000000GGSC0000000
0S00000ST0G00000000000C0000C00
0000T00000S00000000G0000000000
GS0T000S0C0000000000000C000000
0000000000000S0000000S000C0000
00000000000000000000T000G0G000
000000000000T00000000000000000
000T000000000S000S000000000000
00000000000000T000SS0000000000
000G0000000000T00GH00000H00000
0S00G0000000000G00000T00000000
000G0T0000000000000S00S0000000
0000000000G00S00000S0000000000
0000G0000S0000S0G0000000000000
00000000T0000000000000000S0000
000000T0000SG0000G000000000000
00G00000T000000S0000G000000000
0000000G0000000G00000T000000S0
00G000000000S000000000000000T0
00T000000000000000000000000000
