00000S000S0000000000000000C000
000000T0000000000000SG0000G0S0
0T000000000000S000G00000000000
S0000000000000ST0000000000000C
0000000000000000000000G0S00000
T00SG00000S0000000000000000000
0000000000000S000000G00000000G
0000S0000000000000000000T00000
00000000000000S000T00000000000
00G0000S0000000000S0C000000000
0000000000T00000000000000000GS
0S00S0000000T00000000000000000
000000T000S00000000000S0000000
00000000000000G000GS00000000H0
00S00T000000000000000000000000
0000000000SG0000000000S0000000
0000000000000000000T0000000000
000000000000000GG000T000000000
00G0000G00000000S0000000000000
00TG0S0000000GH00000000000S000
G00000000000000000000000000000
S0000000000T0000000000000000GS
G00S0000S00G0000H00T0000000000
0000000000000T0000S0G000000000
00T00S0000S000C000000000000000
000T0000000000000000000000000S
00T0000000000000G0S0000S0C0000
S0TS000000000000C0000000G00000
00000000000000000000T0000000G0
000000000G0T0S00000S00000000C0
