000S000000gg0000000B00tS000000
00S0gg0B00B000000000000000000t
00000000000000000S000000000S00
000000S0000000000000g000000000
0S00S00g000000000000t00g000000
00000000000000000000S00S00t0M0
00000g000000t00000000000000000
0S0000000000000S0000000M000000
00000gg000t0B00000000000000000
00000000g0S00000000S0tg0000000
00000000S00000000000000S0g0000
0000000000000000g0t0000gBB0S00
0000000000000000000St000000000
0S000000000g000000000000000000
0000000000g00000S0000000000000
000S000000000000S000M0000000g0
0000000t00000000000S000000S000
000000t0000S000g000g0000000000
00000t000S00000000S00000000000
00S000t0g0000000000000000000g0
00000S00000S0tg00000M000000000
0000000000g000000000t00g000000
000000000S00g000S00000000000t0
t0g000000000000000000g00000000
g0000S0g000BS000000B0000Mt0000
00000000000000S000000000000t00
000000000000g000000g0000000000
0S000000t000000000000000000000
00000000000t000000000000000000
0000S00000000g0t00000000000000
