000000S0GT00S0000000
S000000T000000G0000S
000000GG000000000000
T000000GG00000000000
000GG0T0000S00000000
0TS000000G0G00000000
0000G0000000000G0000
00ST0000G000GS000000
00000T000000S0000000
00G000S0000G0000T000
0000SG000000GS000000
000G00T0000S00000000
00000000000G00S00000
0000SS00000000000000
0000G0000000000000S0
0G000000S000T0000S00
S0S000000T00000G0000
T0000000S0S000000000
00000T00000000000000
0T00000000000000S000
