00000000000000000S000S0000TG00
0000000T0000000000000000000000
00000000000000000000G0000000T0
00000000000T0000000000S0000000
T0000G00000G00000000S0000000S0
00000000G0T0000000000000000000
00S00000S000M000G0G00000000000
00T0G0000G0000000000000B0000B0
0000000S0000000S0M00000T0M0000
000S000T0S000000000000000G0000
000S0000S00000M0M0000000000000
00G00000T0000000000GB000000B00
0S0G0T000000000000000000000000
00S000G000000000000000000G0TB0
GS00000000000000S0000GB0000BB0
0000000000S00T0000000000000000
0000S0S0000G00000000000000000T
000000000000T0000S00000000S000
0S0000000000000000000000000000
0000000000000000000T00000G0000
0G0S000S0000000000000000000000
000S0000G00000T00G000000000000
0000000000000ST000000000000000
00000000T00000G00000S000000000
00000G000SS0000000000GM0000000
T00000000000000000G0000000000S
00000G0000000000000000000G0000
SS000000M00000000000G00000000M
0000000000T0000000000000000000
000000G000T0000000000000000000
