0G000000000T00000000000000000S
00000000000T000000000000000000
000000000000000S000000000000G0
S0000TS00000000000000G0000GH0C
0G0000000T000000000000000S0000
00S00000T0000G0000000000000000
0T0000000S0000000S000000000000
G00000000G000T0000H00000H00000
S00T0G000000000000S00000000000
000S0000T000G000G000S0000H0000
000TG0000000000000S00000000000
00000G000T0000000000000G000000
00000000000000000G000000000000
000000000S00000G00000T000G0000
000S0000000000G000000000000G00
00000000000000G00000000000000S
000000000000000000000000000000
0000G000T00000S000000000000000
00000000000000G000S0T00G000H0S
00S0GS0G00000000000T000000H000
00000000S000000000SC0000000C00
000000000T0S000000000000000000
0000S0000000G0000000000000000T
00000000T000000000000000000000
00000000000000000000000000S000
00000000000000S000000000000S00
000000T000000000S000000000000G
000000000T00000000000000000000
00000000000000000T000000000000
0G000000TS000000G00S00H0000000
