00000000000000TG00000S000000G0
00T0000000000000000000G000000S
0G00G000000000000000000000SH00
00000G000000000S000000000G0000
T0000S00G0000000000000000000S0
0000G000000000000000T000000000
0000000000000000S00G00S0000000
0S000G00000000000ST000000G00C0
00000000000S00000000000S000000
00000000000S0G000SC000T0000000
000000000GT0000000000000000000
00S0000G00T0000000000S00000000
00000000000000G000000GT0000000
GT0000000000000000000000000000
000S0000000S000C0000000G000000
0S000000000T0000000000S0000000
0000T000000000GS0G000000000000
0000S00G0000T00000000000000S00
00000G000000000000T00000S00000
0S000000000000SC0G0G0000000H00
0T00S000000000000S00C0000000G0
00000S000000G00000000000S000C0
000000000G0G000000ST00000000S0
00000G0000S0S0C00000000000T000
000000000000000S0000000G000G00
0000000T0000000000S00000000000
0000T00000000000S000000G000000
0S000T00S0G0G00000000H00000000
0000G000S000000000S00000000G00
000000G0000G000000T000000000S0
