0000S00000000000T0000000000000
0T00000000000000000G0S00000000
0T00000000000000000000000000G0
00000000000000000S000000000T00
00G000000000S0000000000S000000
0S0G00000T000000000000000000G0
00000000000T000000000000000000
0000G0000000G000S0H0S0C0000000
000000GG0H0S0000000000T0000000
0000000000000G0000G0S000000000
0000000G000000G000T00000000000
GTG0H0000S000000000S0000000000
G0000T0000000000000G0000000000
000000000000000000000000SSC000
00G000000000000T00000000000000
000000000T000S0000000000000000
T000000G00000G00S0000000000000
00000SG000S00000T0000000GH0000
0T0000000000000000000000000G00
0TS000S00000000000C00000000000
S00000000T00S00000000000000000
0G000000000000TG00000000S00000
00000000SS0000000G000000000C00
0000G000000T0S0000S0G00C0H0000
00S0T000000000G00S000000000000
0000T0S000G0000000000S0C0000G0
00000000000S00000000000G00000T
00000000000000G0GH00000T000000
0G0000G00T000S000000H00000S000
00000S00G00T000S00000000000000
