000S00S00000C0TCG000000000G0H0
0000SG0G0H00SH00000T0000000000
0S00000G0000000G000000H0S00000
000000000000T00000000000000000
T00G0000000000000G000000000000
0GS00G00H0000000000000H000000T
0S00000S000G0000000C000000000T
00000000000000000000000SGT0000
0000T00000000000000GS000S00000
SG000000000000GS00000C00000C00
00G00G00000000000000000H0H0000
0000000G00000000T0000G00000000
0S000000000T00000000000000G000
00T000000000000000000000000000
G000G000H0H000H0000HT000000H00
00000000000T000000000000000000
0T0000000G00000000000000000000
00T00000000S00000000GG000000S0
00000000000000000000000000000S
0G00000000000TG00S00000000000S
S000000T0G000G0000000H000000S0
S000000G00000S00C00000T0000000
000000S0000G00000000T000000000
000T0000000000S000000S0G000000
00000G000000000S0000GT00000000
00000000000000G0G00000000TH000
00G000G0SH00000000000000000000
00T0000000000000S0G0000000000S
0000G0G0000000T00H00000S0H0000
0000T00000000000000000S0000000
