00000S00000000T000000S00000000
000S0T000000000000000000000000
0000TG0000S0000000000000000000
000000S0000000T000000000000000
000000000T00000G0000G0000H0000
0S000G00000000000S000GH0000000
000000000000000G0000000000T000
000000000000000000000000000000
000000000000S00000000000000000
0S00G0T000000000S0000000000000
0S000G000000GT0000000000000000
T000S00000000S0000C00000000000
00000T000000000000000S00000000
0GG00S0000000000000S00000000HT
00000G00000000000000000000000S
00000G0000000T0000000000000000
000000000S00000000T00000000000
0000T0S000000S000G00000000000C
0000000000000000000000000GS000
0T00000000000000000G0000000S00
G0000T000000000G0H0000000S0000
000000000000000000000G0000TG00
S0T00000000000G0000G00H00S0000
0000000000000000000000S0000T00
000000000S0000S00000G000000000
0000GSG000000H000000000000000S
000000000000000000000000000TS0
00000000S000000S00000000000T00
0S0S000C00000T0000000000000000
G0000000000000000000S00000000T
