000t00000000000000S00000000000
S0S0000M0g00000000000MM000g00t
S0000000000000g000000000000000
00000000g00g00t000000000000B00
0g000gB000S000000t0B0000000000
0000000t000000000g00000S000000
000000000S00000000000000000g00
00000000g0g00000000S000B0t0000
0g00000000S00t000000g000000000
00000000000000000000S000St0000
000g0000000000000000000000000t
00t0000000000000000000000S0000
000000000000000000S00000000000
00000000000000g00000000000g000
S000S0gg00B0000M00t00000000000
000t0000000000000g0000000g0000
0g00000000000g00000000000S00t0
t00000000000000000000g0000000g
0000g0000000000000000000000000
0S00000000000t0000000000000000
000000g0000000S000000000000000
000000000000000000000000000g00
000000000000000000000000000000
00S00gS000000000000000000MM0g0
000S00000SM000M00t000000000000
0000000000000SS00000000000000t
00000g00000000000g000000000000
000000000000000000g00000g00000
00000000g000000t000000000000S0
000000000000000000t00000000g00
