S000000S00G0G0000000
00000000000000000GG0
0SG00G0S000000000000
0000000GG000000000T0
00000T00S00S00000000
00000T0G00000000000G
00000000SS000000000G
G000000S0000G0T00000
T0000000000000000000
000S0000S0000000000G
0000T00G000000000000
000G0S0S000000000000
000000S0T000000S00G0
0000T0S0000000000000
000G00S0T00G00000000
0G0T0000S0SG00000000
S00S000T0G0000000000
00000S00000000TG0000
ST000S00000000000000
00000G000T0000S00000
