0S00000T000000000000000000G000
0000S0000G00000000S00000C00000
G00000000SS0C00000000000C0T000
00T000000000000000000000000000
0000000T0000000000S0000S000000
00T0000000000000S0G00S000C0000
00000G0000TS000000000S00C00000
000000000000G0000000G000T00000
0000000000000000000000000T0000
00000S00000000S000000T0GCG0000
00000000S0000T0000000000000000
000000000000000000000000000000
00000000T000000000G0GS00000000
000000S0000S000000T00000000G00
0000SG00000G00000S00HH000H0000
G0000000000S00000S00T000000000
000000S0000000000G0000000T0000
000000000000000000000000000000
0000000000S0000T0G000S0000000C
00000000000000000G00000000ST00
0T0000000000000000000000000000
0S00000000000000000000000000G0
SS00CC000T0000000000000000000G
00000000SGGT000000000000000000
000000000000000000000000000000
00000000T00SS00000GG0000H00000
0S000000000000000000000000S000
00000G0000T000000000G00000H000
00000T000S00G00000000000000000
0000G000SG000000000000000000H0
