0000000000000G0T00000000000000
0SSC000000000000000000G0000T00
000G0G000H000000000T0000000000
0000000G00T000000000000000S00G
G000T0000000S00000G00000000000
0000G0S000000000000000000S0000
00G00S00000000000000000G00000H
00TG00S00000000000000000000G0S
000000000000000T00000000000000
00000000000000000G000GHT000000
00000000000T000000000000000000
00000000000G0S000000GH00000T00
000G000000S0000G00T00000000000
000000000000T00000000000000000
000000000000S0000000000T000000
000000000000T00G000000G0000000
000000000000000G000000S0S00000
000000000000G000000SG00TH00000
0T00000000000000G00000000G0000
0G0000000000000000000000000000
G000000000000000000000000000S0
00000T0000000G000S000000S0G000
000000000S000000000T0000000000
000000000000S00000000000000000
000000000G00T0S000000000000000
00000000000000000000000ST0S000
000000GS000000000T000000000000
0000000000000000000000T00S0000
00000000T00000000S000000000000
0000000000000000S000000000T000
