0000000000000G00000000000G0000
0000000000000000TG000000000000
000000G0S000S00000000000000000
T0G0S00000000000000000S00G0000
00000G000S000T000000S000000000
00G0000000000T0000000000S00000
S0G000000000000000000000T00000
00000000000000T000000000SG0000
000000000000000S000T0000000000
0000000S000S000000G000C0000T00
S000000000000T0GS0000000000000
0000000000S0S00C000000T0000000
000000000000000000000000G00000
000T0000G00000000000000G000000
00000000000T0000G0000000000000
000000000000000000000000000000
000000T0000S000000000000G000G0
0000000000S000S000G0000000000T
0T0000000000000000000000000000
00000G00G00000000000T000S00000
0000000T00S00S00000000000000C0
T00000000000000000000000000000
0000000000000000S00000T000000G
000G00000000000000G00000TH0000
000000000000000000TG0000000000
G0T000000G0000000H000000HS000S
T00000000000000000000S00000000
000000000S00000000000000000S00
0000000000000000000000000S0G00
00S000000GT0000S000000000C0C00
