000T00S00S000000000000M0G00000
T000000000000000000S00000G00G0
0000000000000000T0000000000000
00T0000000000000000000000000G0
00000000000000S00000S000000000
0000000S000T000000G000S0000M00
00000000000G00T00000G000000000
00000000000T0000S0000000000000
0S00000000000S0T00000G00000000
0S000000T000000000000000000000
0000000S00S000000000G0000T0M00
000000000000000000000000000GG0
000000S0000GT00000000000000000
000000G00T0000000000000000G000
000000000G0T0000000000S0000000
G000T0000000000000000000000000
00S0S000G00G000M00000T00M00BB0
000G000S000G000000000000000000
0000000000T0000000000000G00000
S00T00000000000GS0000000000000
000T000S000000000000000S000000
G0000000TS0S000G00000000000000
T0000000000000000000G000000000
0000T0000G00000000000000000000
0000000000000000S000S000G0M00M
00000S000000000G00000000000000
00000000G000000000G00B00000000
00000000T0000G000S0000S0G0000M
00000G00S0000000000T0000000000
0G0T00000000000G0000000B0S0000
