000000000S0000S0Mg0t0000000000
000g000t000000S0000S0000000000
000000000000tS0000000000000000
0000000000000000g000000000t000
0t000000000000000g0g0000000000
t0000000g0000000000000000000gS
00t000000S00000000000000000000
000000000000t00000000000g00000
t00000Sg000000000000000g000000
00SS00g000g000M000000000000000
0000000000tg000000000000Sg0000
0t0000000000000000000S00000000
000g000000000000000000000S000S
000000S00t0000000000000000Sg00
00t0000000000000000g000000000S
0S0S00Mt0000000g000000000000g0
00S000g0000000000000000000g000
S00000ggt000000000000000B00000
00S00000S000g000000000t0g00B00
0t00g00S00000g000000S000000M00
000000000000g00000000000000000
0t00g000000000000S000000000000
0000000000g00g000000000BS0S000
0000000000000000t0g00000000000
00000g0g0t00000000000000000000
0000S000000000S0g000000000000g
000000000gg0tB00000000000000S0
0000000000t000000g000000000000
00S0000000t0000000SM0000000000
0000S0000000t00000000000000000
