0000T000000000000000
000000000T0000000000
000S00000T000000000G
00G000SG000000000000
00G0000TS00000000G00
000000000000T0000S00
0S000000000S0G00T000
0G00000S000000000000
000GT00000000G000000
TSS00000000000000000
00000000000TS000000S
G00S000000000000T000
00G0G000000T00000000
0000000T000000G00000
S0000T0S0000000G0000
00G00T00000000000000
00G00G00000000T00000
0000S000GG0000000000
00000000S0T000S00000
S000SG00000T00000000
