00S00SCG000G000000000000000000
000G00S0000000000G0H00000000T0
0000S00000T0000000000000000000
00000SSG00G000000000000000000H
T0000000000000000S000000000000
000T0000000000000G00000G0S0000
0T00000000000000000000S0000000
00T000000000G0000S000000000000
00G0000T0000000000000000000000
0000000000S00000G000000000G000
G00T000000000G0000000000H00000
0000000000T00000000000000G0000
00G0000000000GT000H00000000000
0000000T0000000000000000000000
00S000000000000000S00000000000
S00T000000000000000000S000C000
0000000000000GG000000000000000
00T0000000S000000000G00S00000C
0000T000S00000000G000000000000
00000000000000000000T000000000
00000S00TG000000000000G00000H0
0000S0S00000000G00000C0G000000
000G0SGHH00000000000000H000000
G000S00000000000000000000G0000
0T00000000000000G00000000S000S
0T00G000000000000G000000000000
000S0000000T000000000G00000000
0000000000000S0000T000000S00G0
000T00000000000000000S00000000
00TS000S000000000C000000000000
