0000000000t000S0000000000g000g
0000S00S000000M00M000t000M0g00
000000000tg0000S0000S00g000000
000g00000000000S00000000000000
0000S00000t000000gg0000S000B00
000000000t00000000000000000000
0000S000000000000S00g0MM00t000
000000000S0000000000000000t000
00000000000S000000000000000000
0000tSg0000000000gS000000000M0
000t00000000g00000000000000000
000000000S000g000000t00000S000
000000000000t0000S0000000S000g
g00000t000000000000g000000000S
00t0000000000000000S00S00M0000
Sg000000000000S00000000000t000
0000000000S000SMg000000000M000
0000000000000000000000t000S000
t00000000000000000g000g000S000
S00S00000M00000000000000000000
S0000000000000000g0t0000000000
g00000000000Sg0t00000000000B0B
0000000000000000g00000gS000000
00000000t000000g00000000g00000
0000000000000000S0000t0S00M000
00000g000000000S000000000000S0
000t0000S0000000g000000g000000
0g0S00t0S000000M00000000000000
000t0000000S00000S0000000000M0
00t000000000S00000000000g00000
