0000S0000S000000000000tg000000
0S00t000000000g00S0g00000000B0
0000000tS000g00S00000000000000
00000000S00g00000000S000000000
00000000000000000000g00SSg0M00
00000000000000000000t000000000
S00S00000000000000000000000000
00000t0g000000000000000000000g
00000000000000000S0000S00000gt
000000t00g00000g0000000000S000
S0S00M0000000000000000t0000000
00000000000g000000000000000000
000000000S000000000000g0000000
0000000g0S0S000000M00000000000
S00000ggt000000000000000000000
0000g0000000g0000000000000t000
00g0g0000t0000B0S000000B000000
0000S00000000000000000000000S0
0000t0000000000000000000000000
000000000000000000gS00S0t00000
00000000000000000000000000g000
000S0S00000000000000000gtg0000
000000000000000000t0g000000000
00000000000t000000g0000g000S00
000000S000000000g00t00000000g0
0S00S000MM0000000000000000000t
0000000t00000000000000g00000gB
00St0S000000g00g0000BB000B0000
00000g0000g0000000000000000B0S
0000000t000S000000000000000000
