00000000S0G0000000T0
0000000000T0000000GG
T0G00S00000000000000
S00G0S0C00G00000T000
0000T0GG000S00000000
G00000000G0000000S00
00000T0000G0S0S00000
0000T000000000000000
000S00TS00000000000C
00000T0000000S000G00
S00GTS00000000000000
S000000000000SCT0000
0G0000S00G0000T00000
0000T00000S000000000
000000G0000000000000
00000000000000GG0S00
0S000000G00000G00000
0000000S0G000000T0G0
00000T0G0G000S000000
00T000S0000000000000
