G0000S00000000SG000CH000000000
00000000000000000000000T000000
00000G00000G000H00000000000000
000G0T000G00000000000000SH0000
000S000T0S0000000000000000000C
00T000000000000000000000SGS000
0G00000G000000000000T0S0000000
000000000S0000G0G0000000000000
0000000000S000000G000000S00000
00G000000000000000S0G000000000
0000G0S000S0000T000GH000000000
0000G00000000000T0000000000000
G0T0000000G000000H000000000000
000000G000000000000000000S00S0
S0S0C00000000000000000G0000000
G0S0000000T000S0000G0000C00000
000S00G00000000T00000000000000
000S0000000000000000000000000T
0000000000T00000G0000000000GH0
00T00S00000000000S0C0000000000
000G000S0000G0T00000000000H0S0
0S0000000000000TS0000000000000
0G00G00000000S0S00T00000000000
0000T0000S00000000000G00000000
000000000S000000000000S0000000
00000000000000000000000G000000
000T0000000G000000000000000000
000T0000S000000000000000000000
0000000000000000S0000000000000
00S000G0G0000T000H0000000000S0
