0000T0000000G000000G0000000S00
0000000000000T0000000000000000
T000000000000G000S0000000S000G
00000000000000000G000000000000
00000G00000000000000000000000S
0S0000T0000000S0000G00000GC000
000000000000000000000000000000
0000000000G0G0H00000S000000T00
G0G00000000000000H00000000000T
0000TG00000000000000S00000S000
0000000000G0T0000000000000000G
000G00000T00000G00000000000000
0000000000000000000T000G000000
T0000000G000000000000000000000
S00000G00000000000GS0CT0000000
000T0000S0000000000000000000S0
000000000000000T00000000000000
00000S000000000G00000000000G00
0000000000000000000T0S00000000
0000G000G00000000000000THS0000
T00000G00G0S0000000S0000000C00
000000G000000000T0000000000G0S
S00000T00000000G0000000000G000
000000000000000000000000000000
0000000000000000S0000T00000000
00T00000000000000000000GS0000G
000000000000000000000G0G0H0000
0G00G00S000T000000000000000000
000000T00000000S00000000000000
S000000000000000000000000T000G
