0000000000T000000S000000000000
00000G0000000G000000000000T000
0S0T00000S00000000000C00000000
000000GS000000S000T00000000000
000000S0000000000G00T000000000
00S000S0000T000GC00000000C0000
00000000TS00000000000000000000
0G00000000000000000000000000G0
0S000T0G0G000000H0000000000000
0S000G00000000G000000T00000000
G0T000000000000000000000G00000
000000G000G00T0000S00000000000
00000T000000000000000000000S00
000S0T000000S0G0000000C0000000
0000000000000000SS00G0000CT000
000S0S00GT00000000000000000000
00000G0000000000G0HS0000T00000
G0S0000000S000000000G00000000T
G0000000G0000000000S000H000000
000000000000000000000T00000000
00000T000S00000000000G000S0000
000000000000G0000000G000H00H00
000000000000G00000T00000000000
0T0000G00G000H0000000000000000
0000000000000000T000000000GS00
0T0000000000000000S00SG0000000
00000000SS0000000G000000000C00
0T0G00S0000000000G00H000000000
00000000000000G00T00000000000S
000000000000000G000TS000000000
