0000T00SG0000000000000000G0000
000000G0000000000G0000000000T0
S00T0000000000S000000000000000
000000000000000000ST0000000000
000TSG000000000000000000000000
000000000G00000T00G000S0000000
00ST0000000S0000000C0000000000
00000000000000T000000000000000
000000T0000000000G000000000000
00000G00000S0G000S0000000T000C
00000000S00T000000GG000000S000
00000S0G00000G000H0000S000000H
00000000000000000000000000T000
00S000T0000S000000G00000000000
000000000000000000S0G000000000
T0000S000000000000000000G00SG0
00G000000000G00000000ST0000000
00000000000000000000G000000000
T000000G0000000000S00000000000
00S0000000S000000C000000000G00
0000T00000S00S0000000000000000
0S0S00000000000000000C0T000000
0000000000000000S0000000000000
00000000T0000000000000000S0000
0000000S0G000000S000000C0000C0
00T00000000000G00S000000000000
00000000000000G0000000000S0000
0G00000T000G000000000H0000SH00
00000T000000000000000000000000
0T0S00000S0G000000000000000G00
