t00000000000000000g0000000g00B
0ggS00t00000000000000000000000
00S00000000000000000000000000g
00000t0S0000000000000000000g00
t0g000000000000000S0000g000000
0g0000000g0B00000t000000000000
t00g0000S0000000000S0000000000
0S0000000S0000000000M00t000000
000t0000000g000g00000000000000
0000000S0000000000000S00g00000
000SgS0000M000t0000g0000000000
000000000g000000000g0000000000
0000000St000000000000000000000
0000t000000000S0S0000000000000
000000S00000S0M00t000000000000
000000000000t00000gS0000S000M0
000000000t00000000000000000000
0000000000000t000S0g00g0000000
000g00000S000000g00t00000S0B00
0000t0000000000000000000000000
00000000S000000t0000g000000000
00t00000000000000000g0000000g0
000g000000000000000000S0000000
t00000000000000000000000000000
00g00000g000000000tS000000000S
000S00000000000000gt0000000000
00000000000Stg00000S00M0000000
g0000000000S000t00Sg0000M00M00
000000g000g00000S0000000000S00
g00000g000000000000000BtSS0000
