0000000000S000T00000000000S0C0
G0TG00000S00000000000000H0S000
00000000S0000G000G000000H0S000
0000000G00000000S0T00000000000
00G000000000T000000000G0000SH0
000000000G00000T000G0000000H00
S0000000000000000SGC0000000000
0000G000000ST0000S0000000000C0
000000T0S000000000000000000000
000000G00000T00000000000000000
S0000T000000000000000000000000
0000000000000TG000000G000000S0
00000T0000S00000G0000S00000000
0S00T0000000000G00000000000000
00000G0G0000000000000000000T00
000000G000G00000000000T0H00000
00000S00ST00000000000000C000G0
T0000000000S0000000000S0000000
00000000000000000000000S00000T
00000000000000000S00000S0G0000
T000000000S00000S0G00000C00000
00GG0T0000000000H00S0000000000
000T0000000000S000000000000000
0000T00GS000G000000000000S0000
0000S0T0000000000G000000000000
0T000000G00S000000000000G00000
000T00000000G00GH00SS000000000
00000S0000000000G00000T0000000
00T00G00000S000000000S00000000
0000G00000G00H0000S0000000000S
