0000000000S0T0000000
000000S0000T0S0C0000
00000G000000T000000S
0000000G0000T0000GS0
0000T0G000000S0000GS
G000000T000000G00000
T000000S000000000G00
G0000T0000000000G00S
00000ST00G000S000000
0000000000S000G00000
0000TG000G0000000000
0S00000G00S00000CG00
00S00G0000G0T0000000
000S000000000S00000G
00000000000GT0000000
000000000G00000GS0T0
0SSG0CG0000000000000
000G00000T0000000000
0ST0000000000000G000
000T000S000000G000G0
