0000G000T00000000G000000H00000
000000000000000000000000ST000G
00000000000000S000000SG000G000
0000000S00T0S000C0000000000000
00T00000000S00000000S000000GC0
000000T00000000G0000000000S000
000T00000000000GS00000S0000000
000000S00GG00ST000H00C00000000
00S00000000000T000000000000000
0G000G000000000000000000TS0000
00S00000000S00000000000000G0TG
000000000T00000000000000000000
00000G0T000S0000000000000000G0
00000000000000000000S000000S0T
G00000S0000000000000000S00000G
G0000SG0H0000S00000000000C00T0
G000S0000T00000000000000000000
G00000T0000G0000000H0000000000
0000000000000G0000000000000000
000G000000TG00H000000000S00000
0000000G0000G00000000H00000000
0T00000000S000000000G0GHS0000C
S0G00S000C00000000000000000000
00000S0000000000000T0000000000
0000000S000000000T000000000000
00S00000G000000000000000000000
0S0000000TS000000000000000000G
00000000G00000S00T000000000000
000000000000000000000000000000
000G000S000000000G00000H000000
