0G0000000T000G000000
0000000000000SG00S00
000000000T0000000000
000000G000T000000000
S000000000G000000000
000S0000000000000ST0
00T0S000000000000000
0G0000G00000000000TS
S000000000000T000000
0000T0000000000G0000
S0G000G0000000000000
T000G0000000000000S0
00000000T0000000G000
00000000S0T00000G000
000S0000000000S00G00
0000000T00GS0G000000
00T000000S0000000000
000S0G00STC000000000
00000G000SG000S00000
00T00S00G000S0000000
