00000S0000000T000G00S00C000000
00000000G0000000000000000G0H00
0000S0000G00000G000T00S0H00000
0000000000G00000000000G000000T
0000000000T0000000000000000000
000000S00G00G00000000000ST0000
00S000000000000000000G0000000T
G000000000000000000000000S0S00
00000000S0G000000000S0000G0000
G00G0000000000T000000000000000
T00000000S00000000000000S000G0
000000G000S0S00000000000000000
00000000000S0G000000000T000000
000GT00000000000000000S00S0000
00000S0000S000000000C000000000
00000000S0000000G00000T0000S00
S000T000000G0S0000000C00000000
G0000S00000S00000000G0H0000000
00000T000000000000000G00S00000
0S0GG000SH0000000T0000C0000000
0G0G000S000S000000000000000T00
000000000T00G0G0000000000S0000
00000G00000000000000000000000T
0000000T00000S0000000S00000000
S000G000T0000000000000000G0S00
00000000000000GS0000000G000000
00S00000000000G000000S000000G0
0000G00000000000000GSH00000000
000G0000000T0000000000000S0G00
S000000T000000000GG0000S00H000
