0T00000S000000000000000000000G
0000G0000T00000S0GS00000000000
000000S0000000000000000000G000
0000000000000G0000000000000000
0S000000S000000TG0000G000C0000
00G00G000000000000000000T00H00
00000000000000000S000000T00000
0000SS0000C000000C0G0000000000
0000000G0000000G00TH0H00000000
000000000T00000000000000000000
ST000000S000000000000000000000
00000000000000T000000000000000
000T00000000000000000000000000
000000000000G00000G0H000000000
000S000000S000G000000000000000
GS00S00000000000000CC000000T00
000G00000G0000S000000000000000
0000000000G00000T000000000000G
00GG000T0000H00000000000000000
000T0000000000000S000000GS0000
0000TG0000000000000000000S0000
0G0000S000000000S0000000000T00
000000G0000T00000000000G000H00
0S0000000000000000000S000000G0
000G00000000000T0000G000000000
000000000T000000000000000000S0
0SG000000000000T000000000G0S00
00T00S000000000000000000000S0G
00G00000T000000S00S000000000C0
00000000T000000G00G00000000000
