00000000000ST0000000
000000000000S000TS00
00T0000000000000G000
0000000GSS00G000000C
00000T000G0000S00000
0G000000000000000000
00000G000000T0000000
T00S000S00000000C000
0G00G00T000000000000
S0000S0000C00000000G
000000000G0T0G00000S
0000G00S000S00GC00T0
000000000S00S000000C
SS0000TC000000000000
000000S00000T0G00000
00000000000G00G00000
G00000000000000000S0
00000000000STS00C000
00000000G0000S0S0000
000S00000T000000000S
