00t0000000SS0M0M000g0000000M00
000Sg00000000000S00000M00000t0
000t000000S00g000000000S000000
000000t0000S000g0000000000g000
000g0S000000000000000Sg0M0B000
000000000000000000g0000g0000tB
0g00000000000000000000gt000S00
tS0SM0000000000g0000M000000000
0000gt0SgS000000B000000000000M
000S00gg000000t00000000000S0M0
000t00S00000000g00000000SM0000
00000000g00000S0000SM00t000000
00000000000g000000000000000S00
000S000000000000000000000000S0
S0gS0000000000000g000000t0000M
000000g0t00000000000g000000000
00000g00g000000000B00S00BS0000
000000gS000000000g000B000t0000
00000000000000000g000000000000
00g00000000S0000000000000t0000
0S000tgg000S000000000000000000
0000000g0000000000000000000S00
00000t00000000000000000000000S
SS000000000000000t000000000000
0000000000000g000000000000tg00
000000g00S00t000000000000S0g00
00000S0000000000000000t0000000
000g00g00000000t00000000000000
S00000000t0000000000000SM00000
00000t0g0S0S000000000000000M00
