0g000000t000gB0000000000000B00
0t0000000g000000000000g0000000
0000t0000000000000S00000000000
S0000000000000g000000000000000
00g00t000000000g00000000000000
000000000000000t000000000000Sg
0t0000000000S0000000S000000000
000000000000000000S00000000000
000000000000000000000000000000
0000gSt0000S0000000000000g0000
00000t00000000S000000000000000
00S00g0000t0000000000000000000
000000000S0000S000000000M00000
0000g0000000000000000g00S00000
000000000000000000g000t0000000
000000000000000000000000000000
0000000000000000t000g00000g000
00000000000000t00S000000000000
00S00000g000000000000000000000
00000000000000000000000000000g
000S0000000t000S00g0000g000000
0000000000t00000S00S0000000000
00S000000000SM0000000M000Mt0g0
0000000000000S00t000000S000000
00000000g0g00000B0S0000t00000S
t00000000000000S00000000000000
000000000t00000000S000g0000000
00000000000000000000g0000g0S00
0000t00000000000000000000000g0
00g0t0000S00000000000S0000000M
