00000000T0000000000000000000S0
0G000000G000000000000T00000000
00G0000T0000000000000000000000
S0000000S00C00000000000T000000
T0000000S000G0000000000000S000
00T00000000000G0S00G00000000HS
000G0000000S0GT000000HS0000000
0000000T0000000000000000000000
000000000000S0T0000S0000000000
T0000000000G000000000000000SS0
GS00000G0000S00H00000000000000
00000000000000000000G0S000000G
00000000000000000T00000000S000
000000000000000000000G00000000
0000000000S000000000000000G000
G00S00000G0000000H0S0000000000
00G000T0000000000G000000000000
G0G0000000000000T0000000H00000
0000000T00000000000S000000S000
000000000S0S0T000000000000G000
000000S0000000000T0S0000000000
0T000000000G000000000000000000
000S0000000S00000C0T00GG000000
G000S000000000000G0S0000000000
0G00000S000000T0S0000G0000000C
000G000G000000S0S000000000HC00
T00000000000SG0000000000000000
0S00000000G000G00H000000000000
000SG00T00000000000000000S0000
00000000000000000G0T000G000000
