00000000S0000G000000
000000G00TG00SS00000
G0T0000SG00000000S00
T000G0000S0S0G000000
00000000000000T00G00
0G0SS0000000TG000000
0000S00000000000S000
0000000000TS00G000SG
00T000GG000000000000
0000SS00000000000000
00G00000000000T0000S
T000000000000000S000
0000T000000G00S00000
0000000000000SS00000
000000G0000T000SG000
0000000000000GG00000
00G000G0000TS0000000
00000000T00000000S00
00G000TG000000000000
000G00000000G0000000
