00000t00000S000000S00000000000
00t000S0000g0000000000g0B0B000
00000000000tS00000000000000g00
0t0000000000000000000000000000
0000000t000000000g000gB0000000
000000000S0000t0000000000000S0
0t00S0g00000000S00000000000000
0g0000St000000000S00M000000M00
000t000S00000000S0000000000000
0000g000000S000000S00000000t0M
0000000S000000000t00000S000M00
S0000000S000000000000000g00gM0
t000000000000000g0000000S00000
0t0S0000000SMM0000000000000000
00gg000000B000000000000t000000
00000000000000g000000000000g00
0t000000S000000S000000000M0000
000S000t0000g0S000000000000M0g
0gS0000000000000000t0000000000
00000S0000000g0000t00000000000
g000gBt00000S00000S00000000B00
0g0000000S0g00000t000000000000
00000000000t000000000000g00000
00t00000g00g0000B00000000000B0
000000t000000g0000000000000000
S0000g00000S0M0000000g00MMM00B
00000t00000g00000000000000000g
00000000000000t0g0000000000000
000S00000g0t000000g00000000000
000S0000000t000S00000000000000
