00000S000000t00000g000000g000S
t0000gS000000000000000g000S00M
0000t000g000S000g00B0000000000
00000000S000S00000000000000000
000000000000t00000000g00000gB0
00000000g000000S00000g00B00B00
00000t000g00000S00000000000000
00000t0000000000000g0000000000
00000000000000000000000t000000
00t0000000000S00000000S0000000
00000000000000000g00000000g0t0
0000000000000000t0000000000000
000000tg00000g0000000000B00000
0000000000000000000t000000000g
0000S0000000000000000000t00000
00000t0S0000000000000000000000
0000t000000g000000000000000000
0tg00g00000000000000000000B000
000t00000000000000000000000000
S00g0t000000000000000000000000
0000000000000000000g00000000S0
S00000St00000g00000000g0000000
0SS0000M0gM00000g00000M0t00M00
000g000000000g000t000S000000B0
00000000S0000000S0gg0M00000B00
0000t000000000000S000000000000
0000000gS00000000000000000S000
00t00g0S00000000000000000g0S00
00t000S0000S000000000000000000
000000t0000000000000000000000S
