0T00G0000000000S0000
G00000S0S000T000000G
000000000000G00T0000
G0G00S00000S0000T000
000S0000G00G00000000
0T000000000000000000
00T00000S00SG00G0000
00GT000S0G0000000000
000000000000G00000GT
000T000G0S00000000S0
00S0GG00000000S00000
0T0000000G0000S00000
0000GS0G000000000000
0S0000000G0SG0000000
000000000T0000000000
G0000000G00S00000T00
0S0S0000000000G00000
0000GS00S0000T000000
T0S00000000000000GSG
0000000S00S000000000
