0G000000000000000000T000000000
0000000000000000000S0000000000
000G0000000000T0000S0000G00000
00G00000000TG00000000000000000
G00000000TS00000000G00S0000000
0G000000000000G00000B000000000
00000000000000000T00000000S000
000GG0000000S00000T0000S000000
G0000000T000000000000000000000
T0000SS000000M0M00000000G000M0
TG0S00000000000GS0000000000000
00000000S0000000000T0000000000
000T000000000000000000000000S0
0S00T00000000G0000000000000000
00000000000000ST00000000000000
000000000000000000000000T0000S
000G000000000000S00G0S0T000000
000000000000GS000000TG000S0000
00000000G0000000000G0B0000T000
000000000000G000S0ST00M0000000
0T0000000000000000000000000000
TG0000G000000000000000S0000000
000000000G000000G0000T00000000
0S00GT00000G000000000000000000
000000000000T00000S0000000000G
0ST0000000000000S000M000000G00
000TS00000000000000000000S0000
00000000T0G000000000000S000000
0000T000000000G000000000000000
000000000000ST0000000000S000G0
