0000T0000G0G000000000H00000000
T0000000000G000000000000000S00
S00000T000G00G000000S00000000H
000T00S0000000000000000000G000
000000000000T00000000000000000
00T00000000000000S0000000GG000
000000T0000000000000000S000000
0000T000000G000000000000000000
0T00S0G00000000000G0H000000000
000000TGS0000000000000G00000H0
0000000000000G00T0000000000000
0S000000000000000000G0T0000000
00000000000S00T00000000SG00000
0000000000000G0S00000000000000
0000S0T000000000G00000G0000000
000000000T000000G0000G00000000
0G00000T00000000000000S0000000
0000000G0000T00000000S00000000
0000T0000S000000000000S0000000
000S0S0000000000C00CT00G000000
000000000000000000000GT000S000
G000T00G000000000000000S00H000
00000ST0000000000000000000000G
0S000S000000000000000000000000
000000000000T00GS0000S0000C000
S000T00000000000G00000000000G0
000T000G0S0000000000000S000000
0000000000000000000000000000T0
000000000G0GHS00000000H000T000
0000T00000S0000000000000G00000
