00T000000S0000S000000000000000
00000G000000000000000000S00000
00000G0G0000H0000T0000000S0000
0000T000000000S00G000000000000
00000000000T000000G00000000000
00000000S000000000000000000000
000000000000G0000000T000000S00
00000000000000000000T000000000
00S00S0C0000TG0000000000000000
000S000000000000000G000G000000
0000G0000000S000000SG000000H00
0S00000G0000TG00000S00000000CH
000000000S00S0G000G000000000C0
000000000000000T000000000S0000
000S0T00000000000000000000000G
0000000000000000S00G0000S00000
00000000000S0000000G000000G000
0S0S000000000000000G0000T0000G
0S0S0C0000000T0000000000000000
00000000000000GS0T0000G0000000
S00000000000000000000000000000
S000T00000S00000000C0000000000
00T00G0000000GH000000000S00000
G0000T0000000000000S0000S00000
SGT0000000000000S00G0000000000
0000G0000G0H000H000H00000SST00
G0G000000000000000000000000000
00000000000000000S000000000000
0000000G000000000T000000000000
T0000000SS00C0000000000G000000
