G000000000000000000G00S000H000
0000000S0000000000000T0000000G
000000G000000S0000000000G00000
000000000000000000000000000000
000000G00000000000000000000000
000TG0000000000000G0000H00000H
00000000000000000000G000000000
00000000G0S00000T000000000000S
00000000000000000S00000000S000
000000G000G000H0000000000H0000
000000G000000T00S0000000000S00
000000000S0000G000G000000T0000
00000S00000G0T00000000000S00C0
000000SST000C0000000000000G00G
00000000000000000S0000000T0000
00000000000T0G000S0G000000000H
000000000000000000000000000000
000000S000000000000T000SG0G00H
00000000000000000000000T000000
00000S0000000000T0000000000000
0000000G0GT0000000000000000000
00000000000000000000G000000G00
000000000000000000000000000000
0000G00T0G0S0000S0H0H000000000
0G00G000000000S0T00H000000H000
00000000S000T00000000000G000G0
00S0000G000000000000000S000000
G0000000000000000000S0G0000000
G000000000G00000000000H0SS000C
0000000000GS000G000S000T0H0000
