G0S00G0S000000T00000
00000SG000S000G000T0
000T000S0000GS00G000
00TG0000000000000000
000000S0000000S00000
0000000000G000000000
0G00S0G00000T0000000
S000000G0000000GS0T0
0G000000G00S00000000
00000000000S00000S0C
0T0000000000000000GG
S000000000000000G000
00T000G0000000S00000
000S00000T00000000SG
0000000000G000000T00
000000000S0T0S0000G0
0000G00T00000G000000
0000S00T00G00000GS00
000000G000000T00G000
00000ST00000G0000000
