00S0T000S00CG00000000000000000
00T000000000G00000GS0000000000
S00T00S0000000000000000G000000
00000000000000TG00000000000000
0S0000000000000000000000000000
0S00000T0000000000000000000000
000S00S000G000000000000C000000
000000000S00GT0000S000C0000000
G0G000000SH0T000S00C0000000000
S00000000G000000G00000S000T000
000000000000000S00000000000000
T000G00000000000000S0000S00000
0T000S0000000000S000000C000000
0000T0000000000000000G0S000G0S
00T00S000S00G0000000000G000000
000T00000000000000G000000000G0
000000000000000000000000000000
00000S000000G00000000T00000000
00000S0ST000000000000000000000
000000000S0000000T000000000000
000000000000000T0S00000G000000
0000000000G000000G0HT000S00000
S000S00G000T000000000000C00000
000000000000T00S0000G00000000G
00000G000SS0000T00G00000000000
T000000S00000S0000000000000000
00000T000000000000000000000000
S000S00000G00000000G000TH00000
T000000000000000000000000000S0
000000000000000000ST0000GS0000
