S00000G0S0000000000T
00000000ST000000G000
00T000000G0000000000
00000000000G0GT00000
0000000000000GSG0T00
0T0000G00000S0000000
S0S00T00000000000000
0000000000G000G000T0
G00S00000000G000T000
0000000000000TG00G00
0GS0GT00000000000000
0SS000G0000000C00000
00000G0000T000000000
0000000000GT00000000
00000G0000G000S0000T
00000000T00000000000
0T0000GG000000000S00
0T0000000G000000G000
000G0G0S0000S00C0000
0G0T0S00000S00000000
