0T00000000000000G0000000G00000
000000000000S000000TG000000000
000000000000T0G0000G0H00000000
0T000000000000000000000G000000
0GS00000000000000S0G000000C000
000000GG0000000H00000000000000
00GG00000000000HT0000000000000
00000000000000S0000G0000000000
T00000000000000000000S00000000
000000000000G000000000000000T0
00000G00000S000000000000000000
S0S0C0000000000T00000000000000
0S00000000000T00000000000G00G0
00000G0000T0G000000000000H0000
0000000000000000S00G0000000000
000000TG000000000000000GSH0S00
000000000T00G00000000000000000
000ST0G0000000GS0000H000000000
000000S0T00000000000000S000000
S0000000GT000000S0G00000000000
00S0S0000T000C0000000000000G00
0T000G0000000G00000000000000S0
0S000TGS0000000000000000000000
000000000000000000000000000000
0T000000000000000SG0000000S000
000000000T000000G0000000000000
S0000000000G000S00000000000000
0000000G00000000000T000G000000
000000000T00000000000S00000000
00000000000000T000000G0000000S
