G0S000TS0000000000000000G00000
00000G000000G000S0TH0000000000
000000S000GS00000000000C0TG000
0G000T0G0000S00000S0000H0C0000
0T000000G00000000SS0000000C000
0000G00000T000000S0S0000G00000
0000000000000000000000000G0000
G0S000000000000000000000S00000
000000G000000000T0000000000000
0G000000000000000000G00T000000
000SG00000G0T00000000000000S0C
G000000000000TG00H000000000S00
0000SG0S000000000C0000000T0000
000000000000GGT000H00000000000
0000G00000G0S000H000000000S000
000000000000000000000G00000000
00000000S00000000S000T00C000G0
TSS00000000000000000000000C00G
00000000G0T000000000000000G000
T0000000000000000000000000000S
000000000000000000000000000000
0000000000G0000000000T0000S000
T00000000000000000000000000000
0000T000G00000S0000S000000C000
0G000G0S0000000H00000000000000
00000000T00G00S000000000G00000
00S00000000G0000SCG000T0000000
000000T00000000000GG0000000000
00T000000000000S00000000G00000
00000G0S00000000G0000000000000
