0000000000S0000T00G0
00T00000000000000000
00G00000000000T0S000
00T0000000000000G000
000000T0G0000000S000
000G000T0000000000G0
00S00000S0000T000G00
0000T000000000000000
00000000G0000G000000
00T000S0S00000000000
00T000G000S00S000000
T00S00S00G0000000000
0TS00S0000000G000000
000000G0S0T000000000
000SG0S0G0000000000T
0000G00S00000000T000
00000000G00000G0T000
00000000000S00000000
000000000S0T0000000S
0S000000000S0000G000
