0000000000S000000000S000000g00
000000S00000000SM00000t0000000
0000000t000S0g000000000000g000
00000t000g00000000000000000000
00000S000g0000000000S0M00000g0
0000000000000000000000g0g00000
0g000t0000g00000000000S00B000B
0000000g00000000S00g00000000t0
00S00000t0000000000S0000000000
000S00000g000g000tS0B000000000
00000S00000S000000000000000000
0g00g0000000S0000t000000000000
0000000000gS0g0000000000t0000B
000000000S00t00000000g00000000
00000S0000t00000S0000000000000
g0000000000000g00B0000000S0000
000000000000000t00000000g0S000
00t00000000S00S000000000000M00
t00000000000000000g000000000gS
0000S0gg00S0000000B0000M000000
0000000000000g0000000000000000
0000000000000000000t0S0000000g
00000t000000g0000000S000g0B000
00000000000000000000000g0t0000
00000S0000000g0SM0000000000000
000000t000000000000000000g0g00
0S0t0000000000S000000g00000000
000000000000000S00000000t00S00
0000000000000000000000000000g0
00000S00S0000000t00M00000M0000
