S000000000T0000S000000MG000000
0GG00BT0B0000S0000000000000000
000G00000000000G0B0000000T0000
0000G000T000000GS000000B000000
00000S000000S000000000000M0000
000T00000000000000S000000000S0
S000000S0000000000000G00M0M000
0000S0GG0T000S000000000000000B
000000SS000000M000000T00000G00
0G00GT0000000B000000000B000000
00000T00S000000000000000000000
G000000000T000S000000G000B0000
0000T000000G000S0G00S000000000
000000S00000000T00000000000000
T0000000000000000000G000000000
S000000000000000S00000000000TG
S0000S000000000000000G0TM00M00
T00000000000000G00000S00000000
00000S00T0000000000000000000S0
00000000GS00T0000000GS00000000
00T0000000S0000000000000000000
00G000G000000S00000S0B0000000M
000000T000G00G000000000S000000
00G000000000000000000000000000
T00000S000000G000000000S000000
00000000000000S000G000S0000000
000T00G00S00000000000000S0G000
00S0000000T0000S00000000000000
000000000000000G000S000000T000
00000000000G00000000T000S00000
