G00G00000S0000S0T000
000000T0G00000000000
0T0S0000S00000000000
00000000TG000000GS00
000000G000S000TS0C0G
0000000000S0T0000000
0T00S0000000000000G0
0G000GT000S000000000
00000000000000G00000
S0G0000000S0000T0000
000T0G00000000000000
00T00G0S000000000000
0T00000000000000S000
TG00S00G0000000000S0
0000000S0S0T000000C0
S0G000000GT000000000
0000000G00S0G0000S00
00T0000G00G00000S000
0G000000T000G0000000
0000T0000G000G000000
