00000g000g0000000000000000t000
00000t000000000000000S00S00000
0000000t0000g00000000000000S00
00000000S000000000g00000000S00
0t0S000000S0000000gM000000000M
000000S0000000000000g0000000t0
00000000gt00000000S00000000S00
0S00000000S00000000g000M000000
t0000S0000000S000000000000000M
t0000S00000000000000000g000000
000000000gS0000000000000000t00
00tg00S000000000000000000g0000
000000000000000000000t00000000
t00000000000S00000000000000000
000t00000000000000000000000000
00000000000S00S0g0g0M000BM0000
000g0S00000000S0000000M0000000
0000Sg000000t0000000000000g0B0
S0000000t00Sg000000000000M0000
00S000000t000000000S0000000000
0g00000000g000000000000S000000
000000000g000000t00000000g0000
t000000000S000S000000000000000
0St0S00M0000000000000000000000
000000000t000000000000000000S0
S000000g00000g00B000000000S00t
g00000000S0000000t000000S00000
000000000000000000000S00000000
000000000000S00000g00000000000
000000000000000000S00000000000
