00000000T000GG0000000000000000
T00000000000000000000G00000000
0000T00000000G0000000000000000
00000G000T0000000G000000000000
0000G0T000S000000G000000000000
00000000000T0000000G0000000000
0000000000000000000S0000000000
0000T000G000000000000000000000
00000S000000000S000GG00000T000
T00000G00000G0S000000000000000
00000000000000000000G000000000
000TG0S00000000000000000000000
0G0000000000000G00000000000T00
0T00S0000000000000000000000000
000000000G000000S00000S00M0000
0000G00000T000G00S00B00000B000
000T00000GS0000000000000000000
00G00GT00000000B00000000000000
00000T0000000000000000000G000G
0S000000000000G000SG00000B0000
0S00000G000000T000000000000000
0000000T000000000000G0S00SM000
0S00000000000000000000S0000G00
00000000000G0000000000S0000000
000000000000000000000G00000S00
00000000S000000000G00000000000
000000000000000000000G00000000
00000000000G000000000000000000
000000T00000000000000000000000
00000000000000000G00000S000T00
