t000000000000000000S00gS000000
0000000000tSSg00g00M00B0B0M00B
000t0000000000000000000000000g
0000000000000000000000000gS000
000S0000S0000000t000000g0000M0
00S000g000t0000000000000000S00
0g000g000t00000S00000B00000000
000gt0000000000g00000000000000
00000000000000S00000S00M000000
0000S000000000000g000t00S0g00B
0000S0gg0000tB00S0000000000000
00g0000000000000000000000S000g
0000000g0000g0000S0000000S0000
t00000000000000000000g0000Sg00
00S00000000000000000g00000S000
0t00000000000000000000000S0000
S000000S0000000000000t00000000
S000000000t000g000000000000000
S000000g00g00000000B0000000000
0g0000000000000S00S0M0t0000000
000000S0000000S000M0000000t000
000000000000000g00000000000tgS
0000St00000000g000000SM0000M00
S0000000g00S00g00000t000000B00
00000gt0000000S0000000S0000000
00000000000000000g00g0000B0000
000t000g0000000000000000000000
0t000000g00000000000g000S00000
00000t0000000000g0000000000000
0t00000S00000000S0000000000000
