000000000000000GGT00
S00000G00T00S0000000
G0000T00000S0G0S0000
TG000000000000000000
000000T00000000000G0
G00000000T0000000000
0T0S00000000G000S000
GT000000000G00000000
00000000000000000000
T0S00000000000S00000
GS00000000G0000S0T00
GT000SG0000000000000
0T0000000000G0000000
000000S00S0000T00000
00S000000S000000000G
000000000S00T0000000
000S000T000000000000
00T00000000000000000
GG00ST00000000000000
T00S0000G00000000000
