0000S0000G0G00000000
000000T000000000G000
0T000000000000000000
000000G0000000000S00
00G00S000T0000000000
00000S00000T00000000
000G0T00000000S00000
000T000S0G00SG000C00
000S0S0T00G00000G00C
0000000GG000T0000000
S0S0G0C0G00000T00000
0000GG00000000000000
0000G0G00000T000S000
00000T000000G0000000
G00000T000000S000S00
00T00000000000000000
G00000000G0S0T000000
0000000S000000S0C00T
00TGS000000000000000
0000000000S0000G00G0
