S0T0000000000000000000S00G0000
0000G0SS0T0G000000000000000000
000T00S00000000000000000000GS0
S00000000S0M000000000000000G00
G000000S000S0000000T000000000M
000G0000000000000000G000000B00
00000S0000SMT0GG0000000000M000
0000S00000T000S00000000000G000
0000000G0000000000T00000000000
000T00000G000000000000G0000000
0S00000G0000S00000T00000000000
000000000S00000G00000S0GM00000
0000000G00S00000000000S0000000
000G0000S00G000000T000B000B000
00S0G00G00000000B00000000B0000
0000000000000000S000000G000S00
00S0000000G0T000S0M0000000000G
00000G0T000000000000000000G000
00000000000000000T000000000000
00000S00000G0000G0000000000000
000GTS0000000000000000S00000M0
000T00000000000000000000000000
000000000000S000000S0000000000
000G00000T0000S0S000000000M000
00000GS000000000000000G0000000
000000000000S0000000000T000000
T000000000000000000000000000S0
T0000000000000000000G000000000
00000000S000000S00T0000000G0MG
00000S0000TG0000000S0000000000
