0000000G0SSG0T000000
GS0T000000G000S00000
SS0000000000000000T0
0000S000000S000000T0
00T00G00000000000000
G0S000S00000000000T0
0000G00S000000000000
S00000S0000000000000
00000000G00G00000000
0000000000000S000T00
000T000000000000S0S0
0000TS0000G0S00G0000
000T0G0000000000000S
00TG000000000000G000
00000000S00G0ST00000
000000TG000000S00000
000000000S0G0000000T
T0000000000000000S00
0000000GS0000G000000
000000G000000S000G00
