000000GG0T0000000B000000000000
000T00000000S0000GGS0000000B00
G00T0000000000S000000000000000
T0000000000000000G0G0000000000
00000000000000000G0T00G000SB0S
000000000000G00000000000000000
S00000T00000000000000000000G0S
T000000000000000G000000000G000
0000G00000000000000000000T0000
0000000G0S00S0G00T000000000000
000000000G0G000T00000000000B00
0000T0000000SS0000000000000000
00000000000000G0000000GB0T0000
0T000S0G00000S00000000000G0000
00000S0G000000000S00000000G000
0G00ST000000000000G00000000000
0G0000000G0B000000B00000000000
00ST0000G0000000000000G000S000
GS0000TG0000000000000000BS0M00
0000GT0S000000S0G0000000000000
000000000000000000000G000S0000
000000000000T0000000000G000000
TS000000000000000000000000S000
0S0G0T00000000000G0000S0000000
0000G000G0T000S00000B000S0000B
000000000000000000000T000S0000
00000000000000000S0000000000S0
000000000000000000000000T00000
0G0000000000G00000STS0BM0MB000
000000T00S0000000000000GG000S0
