0S000G000T000G000000
00000000000G0000000S
00ST0000000000G00000
G0000S00S00T00000000
T00S0000000000000000
0000G00000GSS00000T0
T0S000G0000000000000
00G0000S0T000000S000
000TS0S0000000G00000
00G0T00000S0G0000000
0T0000GS000000000000
00000000G00S000S0000
000G000S0000S000000G
G00000G00T0000000000
0TG00S00000000S00000
000000S0000000000000
00000S00TG00000000G0
00S0000T000000000000
T000G0000000G0000000
T000000000000000S000
