00000000G00000000S00
0T00000000G0000000SG
0S000000000S000000GG
00000T00S0000S000000
S0T0S000000G00000C0G
0000000000G000SSG000
0G000000000T00000000
00S000000000G0000000
000000000T0000000000
00000000000000GS0000
G0G00000S00000000T00
00000S00T000S000000C
S000000000000S000C0T
000G0000000000000000
00000000000T00GS00S0
GG000000S000000T000S
0G0T0000000000000G00
G0G0000000S00T000000
T000000000000000S0G0
000G00T000000G00S000
