0S0T0000000000G00000
0000000000000S000000
0G00000T0000S00S0000
0G0000000G0000000000
000000000000S000S000
TG000000000000000000
0000G00SSG0T00000C00
000000000T00SSG00000
00G00G0T000000000000
000G00S0S000C0000000
000T0000G0000G000000
0G0S00G0000ST0000000
00G0T00000000000000G
00G00000T0G000S0S000
0000000000T000000000
000000000G000000000S
0G0000000000T000000G
00G0000000T000000S0S
00G000000S00G0T00000
00T00S00000000000000
