00S00ST000000000000M000G000000
00ST000000000000000S00000000M0
0000000S000000000G000000000000
00000TS000S000000000000M000M0G
000S00G0S0000T0000000000000M00
000T00000000S0S00000M000000000
0000000T00000G0000G00000000000
000G00T00000000000000000000000
00G0S00G0000000000000000000S00
00G0000T00000000000000G0S00000
00000SGT0S000M0000000000000000
000000000000000000T000G0000000
00000000S00000000000S000000000
000G00000000000000T00S00000000
000T000000000000000000000S0000
000S00000000G0000000000G0B000S
000000G00T00000000000000S00000
00000G00000000000G0T0000BS0000
000000000G0000000S00S00000000T
T0000S00G00S0M00M0000000000000
0T00000S0000000S00M00000G00000
00T000S000000S00M000000GM00000
000000T00000000000S00000000G00
00000000S000000TG000000S000000
0000000G0000000000G0T000000000
0000000TG0000G00B0000000000B00
000000000G000000T00000000000G0
000G000G00000T0000000000000000
000000000000000TG000000000S00G
0000000000000000000S0000000000
