GSS000T0000G000000000000C00000
0S00T0000000000G00000000000000
00000000ST00000000000000S00000
0000000000000G00S000000000000G
0S000G0000GS00H000000000000000
000TS000000S000000000000000000
0000G00000000G00000000S00T0H00
000T00000000000000000G0G000000
0S000T000000000G0000G00000000H
00G00000000G00S000T00000000000
G00000T0000000GS0H00000000000S
00000000000000000000S000000000
000000000000SS0G000000000C000T
000000S000000000000000000S00T0
GST000S00G00H00000000C00000000
000000S00000000000000000000000
00000000000S000T00S00G0000G000
00S00000000S0GG0C0000TH0000000
000000000000T00000000S00000000
0G000T000000000000000000000000
G00S00G00000000H000S000C000000
00G00000000000TS00000000000000
000S000000S0C00000000000000000
0T0000000000G0000000000000000S
000000TS00G0000000000000000G00
000S000000SGGT0000H00000000000
000000000000S00000G00S0000C000
000000S00000000000000000000000
0000T0S00000000000000000S00000
000000000000S00000T00000000000
