00g000000000000000000000000000
00000g0S0000000000t00000000000
0S00gS0t0000000000000000000000
S00000000000t0g0g0000000000000
t000000000000000000g0g00000S00
g000S00g0000000000000000000000
t0000000g000000S0S00000g000000
0000000S00000000000S00000000g0
000gS00g000000000000B00t000000
0000000t000g000000000000000000
Sg0000000t0000000SM000g000000B
000S0000g0gB0000000000t0000000
000000000g0000g0000B000000S000
0000000000S00S000t00000g00g000
00tS000g00000000000S0000000000
000tg000000000000g000000000000
0000S000000000S00000g00000000g
000S000t00000g00000gB000000000
0000000000t0000000000000000000
0000000000SSg00t00000000000000
00000000g000000t00000000000000
000000000g0000tS0S000000000000
000000t000S00g0000000000000SM0
000Sg000g0000000S0000t0000000M
00000g0S0g00000S000000000000MB
00000000000000tS0g0000000000S0
00t0g0000000S0000000000000000g
000000000000000000000t00000000
00000000S0g00g00000B000000000B
00000000000000000S000g000000S0
