0T0000000000000G0000000000000G
0000000000000000G0T00000S00000
T0000000000SS0G000000000000C00
000G0000000TS0000G00H00000H000
000000T0000G00000000S000000000
0000000000000000000000000000T0
00S000000000000ST0000000000000
0000000000000000T000000000000G
000000000T000000S0000000000000
000S0000000000000G0000G00S0000
G00000000000000G0T00SH0000SH00
G00000000G000000000000000000S0
000000T00000000G0000000000G000
00T0G0000SS00000000000000G0000
0000000000000000000000000G0000
0000000000000000000000G00GH00S
0000S0000000000T00000000000000
0000000TG0G000000000HH000H0000
0000000000T000G000000000000000
000S00000000T00S0000G000000000
00000000TS00GS0G0000000H0000C0
0000000000S000T000000000000000
000T0SG0G0000000H0000H000H0000
00T000000000000000S000G0000G00
00000000T0000GG000000000000000
00000000000000000T000000G0S000
00000000S000000S000000000G000C
00000ST00G000000S0000000000000
0000S00000T00S0000000C0000000C
000S00000000GSG0H0T000HH000000
