0T00000S0G0000G00000
0T000000000000000000
000000000G000000000S
000S00S00T0000000000
000G00000000T0000S00
0000T00000G000000000
000000000000000S0000
G0T000000G0000000000
0T0000000G00000G0000
000000000G00G00T0000
00000000GT00G0000000
0SS0T00G0000000G0000
0000G00000G0S0T00S00
00000000000SS000T000
0000000T000000000000
00GT00000000G0000000
0S00000000G00G000TSC
0G00S000G000T0000000
00S0G00S0000CT000000
S00000000000000T000S
