0GG0S00000000S0T00C00000000000
00000T0000000000G0000000000000
G0000000000S00T000000000000000
T0000000000000000000000000000G
0SG0000000000000S0000G00000000
00T000G0000000000000G00000H0H0
000000000000S0000000S000000000
000G0000000S00000S0000C0000CG0
0T0S0S000000000000000000000000
00G000000S00000000000000T00000
00GS0000000000G0000H0000000000
00000000000000T000000000000G00
0G000000000G0T0000000000000000
000S00000S00000000T00000C00000
G0000000000000SG00000T00000000
00G00S00000000S00C00000T000000
00ST00G00000000000000000000000
0000000000G000000TS000000G0000
0S0000000000S00000C000000T0000
S000T00S00000C0G000000C0000000
0000000000000000000S0T0000S000
00000T00S00000000G000000000000
0000000000SG0000000000S00000T0
0TG0000000S0000000000000000SG0
00G000000000000S0000000S000000
00SSG0000000T0000000G0C0000000
000000S00000000000000G00000000
000S000000S0000G0000G00000000C
0000S00000000G000000T000000000
0000000000000TG0000000S0000000
