T000000000000000000S0000000S00
00000000000000S0T000000G000000
00000G00000G000T00000000000000
000000000000G0000G00000H000T00
0000000000000G00000000000ST000
0G0000000GT0000H0SH00H000S0000
00S0000000S00G000T000000C00000
00T000000000000S0S000000000000
000S000000S0G00000000000000000
00000000000000G000000000000000
00000000000G00000000000000GS00
0000T00000000000000000S000S000
00000S00000G000000000000000000
GGT00H0000000S000000000H000000
0G00000000000000000000G0000000
00S00000S000000000000000000000
00000T00000000G000000000000000
0T0000G000000S0000000G00000000
000000000000000000000G0000GS0T
0G00S00000T0000000S0G000H0H000
00S000S0000000C0000000000000TC
0000000000000SS0000T000G000000
000S000000000000000000000000G0
000000000T00G000000000G000000S
T000GS000000000000000000G00000
000T00000000000000000000000000
000000000T0000000S00G000000G00
000S0000T0S00000000000000C0000
G00000000000000000000000000000
G000T00000000000000000000S0000
