000S00T0000GS000G000
00000T0G000S0S0G0000
0000000000000G000000
0000GS000000T0000000
0000ST00G0000000000S
000G00000GSST0000000
00G00000G0T000000000
0G00000000G000000000
0T0S0000000000G00000
00G0T000G00000000000
00000G0S000000000000
00G000000000000S0000
0T000000000S0SG0G000
S0S00G0000G000000000
000000T0000000000000
000GT000S0000000S000
0T00G00G00000000S000
000000000G0000S00000
00000S0T000000000G00
00T0000000GG00000000
