000GT0000000000000S0
000G000000000T0000G0
0000S0000000000T000G
00000000S00T00000000
000T0000S0000000000G
0T0000000S0000000000
0000000000000T000G00
0ST00000000000000000
0000000G00000T0000G0
00000S0000000000000S
00S000000GT000000000
0000S00000S00T00C000
000T0000S00000000000
00000G00T0G000000000
S00S0000C00000G0000G
00000G00T00000000000
000000G000000T000000
0G0000000S0000000000
0S0S00C00T0000000000
0G00000T000S000S0000
