0000000000000t00g0000g0000B00S
0000000000g00tS00g00000B000000
0000000g000000000000t0gS000SB0
0000t00000000000S000S0g0M00g00
000000000000000000000000000000
000000000000g00000gB0000000000
t000000g0000000000gB00000B0000
00000t000000Sg0000000000000000
000000000S000000000000g0000000
00g000000000000000000000000000
0000000000000000S0000000000000
0000000000S0000g00t00S00000000
0S000000S00000M000g0M000000000
g0000g0000BB000000000000000000
0000t0000000000S00000000000000
000S0g00000000g000t0S000000000
00000000g0000S0000000000gSM000
00000S000000000000000000000000
0g0000g00B000000B00B0t00000000
00St0000000000000000S00gg00000
00000000000000000000000S000000
0000g0000000000g00000000000000
000000000t0000000000S000000000
S00000000000000000000000000t00
000000t000S0000000000000000000
00t000000000000000000000000000
000000000000g0g0000B000t000000
000S0000000S000g0000000MM00000
000000g00000000000000S00000000
000t0000000000000000S00000000S
