S000000T0000000000000000000000
000000000000T00000000000000000
00000000000S00000000000000G000
0000000000000000000000S0000000
000000S00000T000000000000000S0
0000G0G00000000000000000000000
000T00000000000000000000S00000
000000000000000T00000000000000
000000000000G00000000000000T00
S000000T0G0000S0000000000000M0
0S000000000S000000000000000000
00000S0000S000000G000MG0000000
00000000000000G000S00000000000
000000T000S0000000000000000000
T0G0G00000000S000S00M00BM00000
00000000000T0000G0000000S00000
000T0000GG000B000000000B000000
0000T00000000G0S0000000S000000
00000000T00000000G00000S000000
0000000000000S0000000000000000
0000GG00000000S0S0000000000T00
000000000000S00G00000T0G000000
G000G0S00000000T0000000S000000
00000000000000000000000000000G
000000000000S000000S0G0G000000
S0000S000M000000G0G00B00000000
00000000S00000S0G00T000000000G
0000000S0S00G0M00G0000M0000000
000000000000000000000000T00000
0000T00000000000G00000000GS000
