00G00G000000000000000000S00000
000T00000000000000000000000000
0000T00000000000S0000000000000
0000T0000000000G0G000000000000
000G00000000000000G0000T0S0000
00G00000S000000000T00000000S00
0T0000S0G00000GH000000000S00C0
000T00000000000000000000000000
00000000S0000000T0S00000G00000
0000000000000S0000000S0000000C
0000000000G000000000T00000000S
00000000000000000000G0S0000000
000000000000000000000000000000
000GS0000GT00HH00000000H00S000
00000000000S00000000000T000000
0S0G0000000000000000T000000000
00000000G00SG00000T00H000H0000
T000000000G000000000S000000000
0000G00T00000000000000000S0000
0000000000S0G000T0000000000000
000T00000000000G0000000000S000
00T00000000000000000000000000S
T00000000G00000000000000000000
0000S0000S0000000000000G00G0T0
G000GS00000000000T000000000000
00G000000000S000000000T0000000
T00000000000G00000000000000000
000000000000000000G000T0000000
0T00S0G00000000000000000000000
00S0S000C000000G0000000000000G
