GGS00000000T00000000
000SS00T000000000000
000000T00SS0G0000000
G00000000S0000000G00
T00000G00S000G000000
S000G000S000000000T0
0000TSG000G000000000
00SS00T0000G000G0000
000000T00G000S000000
00T00000000000SS0000
0000000000000000T00S
000000000000S0S00000
000000T0G0000000S000
0G00000T00000000G000
T00000000000G0000000
0000TS000000G0S00000
00T00S00000G0000S000
0T00S0000S0000000000
000000T000G000G00000
00T00000000000000000
