000T000G00000G000S000000000000
0T0G0000G000000000000000000000
0GTG0000000000000000SH0S000000
000T00000000000000000000000000
000000T000000000000S0000000000
00000000T000000000000000000000
0000G0G000000H000S00000S00T000
0G0000S00000000000T0S000000000
0T00000000000000S0000000000000
00T0000000G00000000000000S0000
000000000000000000000G0000T0G0
000000G000S00000000000000S00GH
0S000000T000000000000000000G00
T00000000G00S000G0000000000000
S0000T000000000000G00000000000
000TG0000000000000000000000000
0000S0T0000000000G0000S0000000
00000000S00000000G0S000T000CC0
0G0000000000S00000000000000000
000000000000000G0S000000S00000
00000T000000000G0S0G000H000S00
0000G000G000000000000T0000H000
G00GT000000000H0000000000000S0
00000000T0000G0000000000G00000
00000000000000000000000000000G
0000G00000000T0000G00000000000
00000000S000S000000000GT000000
0G0GT0H00000000000000H00000000
000000000000000000000T00000000
000G00000000S0000000000T0S0000
