00T000G00S00000000000G00000000
0000000G00000G000T000000B00000
00000000000000000000000T000000
00S00000000000S00000000G000000
0000000000S00G00000000GT000000
000GS000000S00T000000000000000
G000S0T000G0000000000000000000
0000000S000T000000000S0000000M
0T00G00000S000000000000000G000
S000GS0000T000000M000000000000
000000000000T00000000000000000
G0000000G0000000TS000SMB000000
0T0GG0000000000BS00000000S0000
00000000G000000000000000000T00
000T00000000000000000000000000
T0SS00000000000000000000M00000
000000000000SG0T0000000000S000
00000000000000000000000000S00S
00000T000000000000000000000G00
00G0000S000000000S00G000000000
G000G0B000000B00S0000000S00M00
000000GS000TS00000000000000000
00000000GGB0000S00ST00M0000000
00S0000000000000S0000G00M00M00
00000000000000G00000000T0000S0
000000SS0000G00000G00000000000
00G0T000S00S000000000000000000
G0ST0000000S000000000000GM0000
0GS0000T0S00000000M00M00000000
0000000S000S000000000M0000M000
