0T000000S0000000G000
000T00000000G0000000
0000000S0000T0G0000S
0T0S00000S0000000G00
00G000T00000S0000000
00S0000S0000000000C0
T0000000S00000000S00
0000000000000G00T000
0000000G0S000T0G000S
0STS0000G000000G0000
000000T00000000000G0
00000SG0000000G00S00
000S0000SCT000000000
0000000000000G000000
000000000000T0000000
0G0S00000T0S00000000
S00000T000000SG0C000
000S00000000T0000S00
0T000G000000000S00G0
00000TS0000000S00G00
