0T000000000000000000
0S000G00000000000000
00000G000S000G000000
0000000G00G0T0S00000
T00S00000G0S00000000
0000000S000G0000000G
GTG000000S0000000000
0000000000S0S0000000
T00000000S0000000000
00GS00T000000000S000
00000S0T0000000000S0
SG00000000S000000G00
T00G000G0000S0000S00
00000000000000000000
0TG000000000GS000000
000000000GS000000000
G00000T0000S0S000000
S00GG0000000000S0000
0000T00000G00S00000S
T000SG0000G00000000S
