000000T00000S0S00000
0000000000G000000000
00G00000SG00ST000000
00000S000000S0000000
0S0TS000000000000000
0T000G00G000S000S000
S000S00000G000000000
T000GS00S00G00000000
00000000000000000000
0G0000SS00T000000000
0S00T000GS0000000000
T0G000000S000000000G
S00T000G0G000S000000
00G00T00000000000000
0T00000000S00000SG00
0000T00000S000000000
S00G0000000000000000
00T00S000GS0G0000000
00000000G00000G00000
0000000ST00000000000
