00S0000000T000000000
G000G00000000S000000
0000T000000000000000
G0TS000G000000000000
000000T0S0G000000S00
00000000000S00000000
0000TS000000S0000GC0
GS0000000000G0000T00
0000000T000000G00G00
0000000000T00S0S000C
0S0000000GST00C0000G
0T00000S000S00000000
000T0SS00000000000C0
T000000G0000G0000000
000S000000000S000000
000000000000000G0000
00T000000000000G0000
0G000S00000000000000
S00T000GG00000000000
00000000G00G00000000
