0G0000G0ST000000000S
000SG000TG0000000000
0S00T000G0S000000000
0000T00000G00000G000
00S0TG0000000G000000
00000G00000S0TG0000S
00SS00000000000G0000
0S00000T000S00000000
T0G00000000000000S00
0S000T000000000000G0
000000S00G0ST0000000
000000G0000000000000
00T00000000S0000S000
00G00000000S0000GT00
00S000GT00S000000000
0G0000GSS00000000000
00000000000000000TG0
G00000000T00S0000000
0T0000GS00000S000000
000G0S0000G0000S0000
