T00000000000000000000000000000
0S000000T0S0000000000000000000
000000000S0S0000M0G00000T00000
00000G00000000000000G0S0B00000
00TG00G000000000000B0000000000
0G000G0000000000T0000B00000000
000T00000S00000000000000000000
0S00000G0000000000000000000000
0000000000000000000000S0000000
00000TS00000G00000000G00000000
T00000S00000000000000000000000
0000000G00S00000000000S00000M0
000000000S0S00G00T000000000000
000S0S00000T00G0000000000GB000
000000T0S0S000000M0M0000000000
000000000000000S0G000G00000000
0000000000000000G0S00S00000000
000S0SM000G0000000G00000000000
00000G00000000S00T000000000000
000000T00000000G000000000S00S0
00000000000000000000T000000000
000000000000000T00000000000000
00S0T000000000S00GG00000000000
T00000S000G000G000000000000000
GG0T00000000000000000B00000000
0S000S000000G00G00000000B00000
00000000000G0000000000T0000000
0S000000000T000000000000000000
T00000000S000000S00G0000000000
00000000000000000000GGB00T0000
