000000000t000000000000g0000000
0000S0t0S000g0000000000g0000B0
00000000000S0000000t00g0000000
0000St0gSM00000000000000000000
0000000000S000000000g000000000
0000g0000000000gt000000000B00S
000000000t000000000000000g0g00
000000000000000000S0S000M00000
000000S0000g000000000000S00000
0000g00000gB0B00S0000St00000M0
g000000000000St000000S00M000M0
000S00000000t00000S000000g0M00
00000t0000000g000S000000000Sg0
00g00000000000000000000t000000
00t00g000g0000S0000000000B0000
000000g000t0000000000000000000
00000000000000000000000000000S
00S00000000S00g00g000000B00000
0000000t00g0000000000000000000
0gg000t00000000000000000000000
000t000000000000g000S000000000
000S0000000t0000gS000000000M00
0t00000000000S0000000000000000
00000000000000t00g00S000g00000
g00S0t0000000000S000000000g000
000000000t0000g000000000S0g000
0g000000t000g00000000000000000
000S0000000000000000000t0000g0
0S0000g00000t00000000000000gB0
000000000t0g000000000S00000000
