0G0000S0000000000000
0T000000G0G00S000000
0000000000000000GSG0
00S0G000000000000000
00G00000T0000G000000
00000000000000000000
00000T00000000000000
00S0SC000G000000G000
0000S0T0000000G00000
GT0S0000000000G00000
T0S0000000000G000000
000G00000G0000000000
S000T0S0000000000C00
00000000000000000000
T000G00000000S000000
000000T0000G0S00S000
00T00S00G0000G000000
0SG000TS000C00000000
00000000S0S00C000000
00T0G000000000000000
