00T000000G0S0S0C0000
000000S0G0G00000T000
0000000T00000000GS00
G00T0000000000G0S0S0
S000G000000000S0000T
000S000000000G0000G0
000T00S0000000S000G0
00GG0000T00000000000
000000000T0000000000
0T000000000G0000SS00
000000GT000000000000
0000000000000000G000
000000000S0000000000
T00000S0SC00000000G0
00000T00000000000000
G0T0G000000000000000
T000G00SSG00000C0000
00000000S00000000000
0000G0S000TG00000000
GSS000C000G000000000
