000000S0T000000000G0000G00H000
000T0000S0000000000000G000000G
000S00000T000G0000G00000000000
0000000000ST000000000000000000
0G000000T000000000000000000000
00000000000000000T00000000000G
TGG000000000000S00000000000000
000GST000000000000000000000000
G0S00TG000H0000000000000S00000
T00000000000G000000000SS000000
00T0G00000S00000SGH000C0000000
T00000000S0G0000G0000000S00000
000SS00000000000CT000G0G00H000
000000000000S00000000S00000000
0000G000000000S0000T0000S00000
0T000000G000000000000000000000
000000000G000G00000S000000H0T0
00000SG00S0G0C0000000000000000
00000000G000000000000GT0000000
0000S0000000000G000000S0000000
00000G0G0S0S000000C0000000000H
000T000G00000S000000000S000000
00000S00000000T0G000G000000000
000000000T000000000000000G0000
00000000000000T00000000000000S
00S0000SG000C000T00G0000H00000
0000000S0T0G00G0000000S000H000
0000000000T0000000000000000000
00000000000000000S000T00000000
00S0000T00000G00000SG000000000
