T00000000000G0000000G000S00000
0S0000000000000G0000000000000T
0G000S0000G000000000000000000H
00000000000000S000000000000S0G
000G0000000000000T000000000000
00GSG000H0000000000000S0000000
0000T0S0000000GG0000000H000000
G0G0S00000H00T0000000000S00000
00S00000000000000000T000000GG0
0000000000S0G0S000000000000000
0S000000000000000000S0T00G0000
00000000000ST00000000000000000
S0000S0000000000T00000000000C0
0000000000G0000000000000S00000
0000000000000000S00T000000G000
0T00000000000S00000000S0000000
0S0000T00000000S000000C0000G00
0T000000000G00000000000000S0S0
S0000000000000S0000000C0000000
0T00000000S0000000000000000000
00G00T00000000S00000G000000S0C
00000G000000GTS0000S0H0000C000
0000000000000000000000S0000000
00000000000000000000000G00000G
G000000SG00H0T00000S0000000000
00000000000000000G0000G0000000
S0000000000000S00000000000T000
000S0000000000000S00000T0C0000
000000000000S0S000000000G0T00C
GG00H0000T000000000000S0000000
