00000000000000t0S000S000000000
00g00000000S0000tS00g0B0000000
0tg00000000000S000gS000000000M
000000000g000g000000S000t00000
00000S0000000000000S00000000gg
000000000000S00000g00000t0000S
00t00g00000000000S00000000g000
000g00000000S000g0000B00000000
0g0000000000000000000000000000
000g0tS0000000g000000000000000
0000000g0000000000000000S00000
0000t00000000g0000000000000000
g0000000000000S000S0000000t000
000g00g000000000000S00t00S0000
000000000000gS000000000000000t
000S00S00gt00gMMB0M000B0000000
000000S0g0000000000S00tg0MMM00
00g000000000t00000000000000000
0000000S00000000000000g000000S
000000tg0000000000S000000g000B
000000000000000000000000000000
0000000Sg000000000000000t00000
g0000St00000000000000000000000
00000g00000000000000000000t0S0
t00g000000000000000000S0000000
000g0000g0BSt0B00S000000000000
0000000000t00g0000000000000000
0t0000000g0S000000000000000000
S000000gtSg0000000000000000B00
000000gg000000000000S000000000
