00S000000000T0000000
00000000SS0C00T00000
000TS00000S000000000
0S000000000000S00000
00000000S00G0G000000
00ST0000000000000000
0000SS000000T0C00000
000000000TG0000S0G00
0000GG00000S000T0000
G0G000000000T00000S0
G0GT0000000000S00000
SS0T00000G0G00000000
000T00S0000000S00C00
0G0000T00G0000000000
0000T00S0000000000S0
00000S0TS000000GG000
0G0G00T0000000000000
0000SS0000000T000000
S000000000T0S0000000
000S000S000000000000
