00000t0000000g000SS000M0000000
000000000gg00000000B00000000Bt
000000g00000000t000000000g0000
00S00000S000000000M00000g00t00
000000000000000000S000000000St
0St0S00000M0000000000g0g000M00
0000t0000000000000000000000000
0t00000000000000g00000000g0000
00gt00S00000000000000g00000000
t000000000S00000000000000g0000
0000000000000000t0000000000000
000t0000000g00000000g0000B0000
00000S00000g00S0000000000000M0
00000000000000000t0000S000000S
000t00000000000000000000000g00
0t00000000000000000000000Sg000
00S0000000000000gSt00000000M00
00000S00000000000000000g0000g0
0000000000000000t0000000000000
00000000000000g000g00BSS000000
000t00000000000g00000000g00000
g0S0000t00000g000000000SB0M00B
00000000000g00S0t0000000000000
0000000g00000000t0000000000000
00S0000S0M000000000000000t0000
00000t000000000g00000000000000
t0000000S0SM000000000000000g00
0000t000000000000S00000g000g00
g0000000g00000000Bt00000S00000
0t0000000000000000S000000g000S
