000000S000T000S00000000M000000
S000000S000000000000000T000000
00000000000000000000000S000G00
00000000000000000000S0G0S00MM0
0000G00000T0000S0000G000000000
0T000000000000G000000000000S00
000000000G000S0000000000S0000G
T0000S00000000G000000000000000
0000000000000000000000S000S00M
000S000T0S0000M000000M000M0000
S00T0000G0000000000000G000S00B
000G0S00G0B00S00000BT000000000
000000S000000000000T0000000000
0S000000000000SG0000000M000000
00G00T000000000000000000000000
000000T00000000000000000000000
000000000000000G00000000G00SS0
0000000000000000000S0000000TG0
0000000000000S0000S0GM00000000
000000SS00000000000000G00M0000
000S00GT0000S0000000000M000000
00000000000S00S0000000M000GT00
0000G00000T0000000000000000000
000S0000000000000S0000M0000000
0000000000000000S0000000000000
00000000000000000G0000S0G0000S
0000000000000000000000000G0000
GT0000000S000000SGBB00000000B0
00T00G000000000000000000000000
000G000T00000S0000000000000G00
