000000000T00000000S0000000000G
T000S0000000000000000000000000
000000000000000ST00000000000G0
0G000G0000000000000S0T00000000
0000000000000000S0000T000000SC
000000S000000000000ST000000000
000000TS000S000000000000000000
0000000000000T00000S0000000000
000000000T00000000G00S00000000
0S0000T0S0G000000000G000H00000
00000000000000T00000S000000000
S0000S00000000000000C000000000
000000T00000G000000G0H00000000
0000T0000000000G0S000000000000
T00SS0000000000G00000000000000
0S00000SCC0G0T000000000000C000
G000000000000000000GH000000000
00GG000T00S000000S000000000000
0000G00G0H0T00H000000H000S0000
00000000000T000000000000G00G00
00000S00G00000T000000000000G00
000S0S00000C0G000000000GT000CC
0000000000000000T0000S00000G0S
000000G000T00000000SS0G000H0C0
0T0000000G0000S000G00000000000
000000000G0000S0ST00000000C000
T0000000000000000000G000G00000
T0S000000000000000S00000G00000
00000000S00S000000000C000G0000
G0G00H000000TH00000H0000000000
