000000000000000000000000000000
00000000000000000000t0g000000S
0000g000g000000000000t00000000
00000000000S0000000000000t00S0
00S00t000000000000000g00000S00
0000S0000000gg0000t00000000000
00t000g0g0000000S000000000000S
S0000S0000000000000000g000M0t0
0000000gg00000000B000S00000000
000000000000000000000S000000t0
0gSg000000000t0000B00B00000000
000S0t000g000000000000000000SM
00000Sg000t0000000000000000000
00000000S00000000S000000000000
0S000gS00000000t00000000000g00
0000t0S000000g00000g0000000000
00000000000000000t000000000000
0000t00g0000000000000000000000
000000000t0gS0g0B0B00000000000
00t00000000000000000000000000S
00000000000t000000000000000000
00000t0000000g00Sg000000000000
00000t000000000000000000000000
0000000000000g0000S00000000000
tS00g0S000M00000MM000000000000
000000000t00000000000000000000
0g000000g00000t000000B0S00S000
0000000000t000S000g00000000000
00000000t00g000000000000S00000
0000g00g0000000000000Bt000S000
