0G0000S000000000T000G000000000
0000G0000T0S000000000000G00000
0000S0T0000000000000S000000000
00G000000S0000000000000S000000
0T000000S00S00000000000000G000
T00000G00000000G0000000000S00H
0T0S00000G0S000000G00000000000
000T00000000000000G00000000S00
S0000000T0000000000000000000S0
000000G00T000000000G0000000000
0S000T0000000000S00C0000000000
000000000000000S00000G00S000T0
G000000000TS0000000G000000000S
00000S0T00000000000000000G0000
TG0000000G000000000S0000000000
0G0T0000G00H000000000000000000
00000000000000G0000000T0000000
0G0S000S000C00GT0000000H000000
00000SG000000000000000000G0000
000000SG0T00000000000000000000
00S000S00000000000G0000C000000
0000000G0T00000000000000000000
00G000000G00000000H00SH0T00000
000S00000T00000000000000000G0G
000T0000G0G0000000000000000000
000000000000000000000000000000
0000S0G0S000C0000000C00000000G
SS0000000000000000G00000GC0000
000G0S000T0G000000000S00000000
000000000000000000000000S00000
