000000000000G000000000ST00S000
G00T000000G000B00000000000000B
00000GS000000S00T00M0000000000
000000T000S000000000S000000000
000S000000G0T00000000000000000
00000S000000000000000000000000
00G0000000T00G000000S000000000
00S000G00000000T0000000000S000
0000000000000000GG0000000S0SB0
00000G0T0G0000000000000000000S
000000000000000T00000000000GG0
T00000000S0G000000S00000000000
00000T000000000000000000000000
000T00000000000000G000000000S0
000000000000000G000000G00000S0
0T0G0000G00000000000000S000000
00000S000S0T000000000000GM00G0
000000000000000000000000000000
000000T0000000000G00G000000000
000S00000000000000000000000000
0000000T0GG0S0S000000000M0B000
0000000T0000000000000000000000
000000000000000000000000000000
00000000000T0G00000G0000000000
000S000T000000000000SGM0000000
0G00G000000T00S00000000000000S
G00T00000000000000000000000000
0000000S00000000000000000G0000
0000S00000000S0000000000000000
0000000G0G00B0000000000000BBS0
