G000000G000T00000000
GS00T000G00000000000
0000000000TG0000S000
00000000000T0G000S00
S0000000T0000G000000
00T000000000G000G000
0S00TGG0000000000000
00000000T0000S00G000
0T0000000000000S0S00
000GT000000S00000000
00TS0000000000000000
00000SS00G00G00T0000
000S00T000000000S000
0000000000000T000000
00G00000000000000000
0S00000S0000000G00G0
00G00S0000S000000G00
G00T0000000000000000
0S00T000000000000000
00000S000G0ST0000000
