0000G00000S0000000000000000000
S00S0C000000000G000000G0000000
0000000000S000GGS00T00000C0000
00000000G000000000000000000000
0G00000000000000000000000T0000
0000000000000000S0000000000S00
0000000000000S00000000000000T0
0S0000S00T000000C0000000000000
0000000T0000S0000000000000G000
000G00S0000000000TG0000S0C0000
0000000000S0000GGT00000000H000
00000000000SSC00000000G00G00T0
00000000T0000000000S0000000000
000000000000G000000000S0G00000
000S00000000000T0000S00C000000
00GS000000G000S000000000000C00
0000000T000000000000000G0G0000
0000000000S0000000G00000000000
00T0000G000G000000000000000000
000G0000000000S0GS000C000000H0
S0S000C00000000000000000000000
00T0000000000000G00000000000GS
000000000000000000000000000000
0000T00000000000000000S0000000
00000000000S0000000000000G0000
000000000000000000G00000000SS0
0000000000000000000S00G0S00T00
0000000000000T0000000000G00000
00T000000000000000000G00000000
000GS00T000000000000G000000000
