00000000000000000S000000000S00
00000000T000000000S00000000000
G0000000000000000000T000000000
000000G000000000000S0S00T0C000
T0000000000000S00000G000000000
00000T0SG000000000000000S00000
00000000000T000000000S00000000
000000G00000T00000000000000000
000G0000000000000000000ST00000
000GG0000000T0S00000H000000000
0000S0000000000000000000000000
00000000000000000G00000T00S000
000000000SG00000000000S0000G00
0000000T000S000000000000000G00
00000G0000000G000T0000S0000000
S00000T00000000000000000000000
00TG00S00000000000000000000S00
0000000000000000000000T0000000
00000000S00G000000000000G00000
0000000T00G00000000000G00S0000
G0000000T000000000000000000000
00000T00000G000000000000000000
00G00000T0G00000000000S000000H
00000000G00000000000000T00G000
000T00000S00000000000000000000
00000T000000G000000000000000G0
000000000S0000000G00S000TG0000
0000000000000000000000000000G0
0000000000000000000T0000000000
00S0000S0000G0000TC000000G0000
