00t00S00000000000Sg000M000MM00
00000000000S000000000000000000
g00g00S00S0t0000000000M0000000
000000000t00000000000000000000
00000000t00000g0000000g0B00000
000g00000S0g0S0000000B00t00000
00000g0000g0B0000B00B00BB0S000
00000S000Sg0000000000000000000
000000t00S0gS00000000000g00000
0000tg00000000000000000000S000
000t0000000000S000000000000S00
000S0000S00t000000000000000000
0S00000S00000000000000g0M000t0
00t0000S00000000000000g0000000
00gg0000000000000BS0000S00000M
00000000t00000000S000000000000
00000000000000000000000t000000
000S0S00000t0000000g00000Mg000
00000000000000000t00000S000000
00Sg0000t00000000000000g000000
0000000000g00t0000000000000000
0gtg0B000000000000S000000000B0
0gt00000000g0000000S00000000B0
0000000000g000000000000000000g
000t0000000000000g000000000S00
0000000000S0g0000000S0M0000000
00000S00g000000S000000000gM000
S0S0t00000000M00000g0000000000
00000000S000000000000t00000000
000g000g00B0000000000000000000
