000000G000000000S0T0
G0G000S00S00000T0000
000000000GS0000000T0
0T00000000G0G0000000
00000T000000000G0000
0T0000000000GG000000
000GG0000000000T00S0
00G00000G0S0TS000000
0T000000000000000000
G0000000000T00000000
0T000000S0000G000000
000T000000000000000S
0G0000T0G00000000000
0000T0000000GG000000
000000S0S00G00T0G000
0S0G00000000S0000000
0GS00000000T00000000
T0000G0S000G000S0000
G00000T0000SG00S0000
00000S0000000000G0T0
