0T0000G00000G00000B00000000000
000S0GS000000000T00G000B0000B0
0000000S0000G000T0000000000000
00000T0000000000000G0000000000
G0000T0000000000000S00000000SM
000000000G0000G0000000000T0000
0G000000000000S0000T0000000000
0000000000G0S000S000M000000000
00S0G0T00000000G0B00B000B00S00
00000000T000000G00000000000000
000GT00G00000B00SB000000000000
0S00000000S00M00M0000000000000
000000T0000000000000SS00000000
0000T000000000000000G00000000G
00000000ST00G000G00000000000B0
000000000000T00000S00000000000
0G00T000000000000S00000000S000
0T0G000000000000S00G0S000000B0
S0T00G00000S00000000G000000000
00T000000000000000000000000000
0T0000000000000000000S00000000
0000S0000000G0000000000G000000
T000000S000GG0000000S00B000000
000ST0000G00000000000000000000
00000TG0S00000000S0000000MGM0B
00000000T0000G0000000S00000000
0000G0S0ST000000G000000B000000
00000000000000000TG00000SS0000
00000000000G0000S0GB0SM000B000
G0000000T000000000000000000000
