0t0g0000S000000000S000M0000000
00000000g000000000000000000S00
000000000000g00g0000t000000000
0t0000000000000000000000000000
S00000000g0000000000000t000000
g000t000000000S00000000000000g
00000000000000000t000000000SS0
0S0000tS0000000000000000000000
000000000000t00000000000000S00
0000000000t0000000000000000gS0
0000000t00000000000S0000000000
00S00S0000000M00000000000000tg
t000000000000000g00000g0000000
00000000000000S000000000000g00
00000000000g00000000000000t00g
0000g0S00000000S000g0000t00000
0000000000000000g00000000S0000
0000g00000000000000g000000000S
0000000S00S000000g000000M00000
000000000000000000000000t00g0g
0000000g000S00000000000S000000
000000t000g0000g00000000000000
00000t00000000000S0g0000000000
00g00t000g0000000000000000000S
00000000000S0000000t0000g000S0
000S000S00000000g0000000000gM0
00000S0000000S0000t000000M0000
t000000000g00000000S000000S000
00S00t000000S0000000g000000000
00gS0000000000000000g000000000
