00000G0000000000000T0000000000
000000T0G000000000000000000000
T00000000000000000000000000000
0000SG00T0000G000000000000000S
000000000000G0G0000B000S0000T0
0000000T0000000000S00000000S00
00000S0T000000000000000G000000
000000000000S00000000000000000
000000000S0GG0B00000000B0S0000
00000SG000G00S000M0M0000000000
00000GS00000S0000T00000000M000
00000G00000GS0000000000000T000
0000000000000000000000S0000000
000000000G0000000000000000G00B
0TG0000SS00000M00000000G0000B0
00000000S000000000S00000000000
00000G0S000000T0000S0GM0000000
0SG000S000000000000000000G0T00
0G0000T0000000000000S000000000
00000000S000G00000000000000000
0SG00000000T000000000000000000
000000S0000000G000G000000B0BB0
00000000000S0000T0S00000000000
000000000000000000000000000000
0G00000000000000G0T0000S000000
0000000G0000000000S000G000BS00
TS0000000000000000000000000000
0000S0000000000000000000000000
0000000G00000S00T0000000S0000G
0S0G00TS0M00000G00000000000000
