000G00T00000G0000000H000000000
00G0S0000000000000000000000000
000000G00S000000G0000000000000
0000G0000000000000000000000000
GG0000S000000000000000H0000000
0000000000000000000000T0000000
00000000000000000000SS00000000
0000000000000000000T00SS000000
000000S0000S000000000000000000
00T000000000000000000000000000
0GT00000G000H00000000000000S00
S000G000000000000SC0000T000000
0000000SS000T0000000000000000G
0000000T000000000000G000000000
0000000GS00000000G00000000000H
000000S0S00C0000T0000G00000000
0000000000T00000000000000000S0
0T0S00G0000000000000S00000G00C
00000000000000GG00000000H00000
0T00SG000G0H000000000000000000
00000G0G000H000000000000000000
00000GT0000000G000000000000000
G00S000000000S0000000000000000
S00000000000000T00000000000000
0T0000000000000SGG0000H0000000
000T000000000000SG0000G0000000
000GG00000000S0000H00000000000
00S0000T000000G00000S0C00000G0
0GS00G0000SC000000000000000000
G000000000G00000000S00000000T0
