G000000000000T000000000000G0H0
GG0000000000000HS000000S000000
000S000000000000000000G000G000
00000S000000S00000G0000000T000
00S0000T000000000000000000G000
00S0G0S00000000000000000GH0000
000000SG0S0TGC000000000H000000
000G00T00S0000000000000000G000
0T0000000000000000S0000000S000
00000000G000000000000000000000
0S000000000000000000000000T000
0000000000000T000S0000S0C00000
000000000000000S0T0G0000000000
0G0000000000000000G0000000S000
000T000000000000G000000S000G00
0000000T0000000000000000S00000
00000G0000000000000S0000000000
SG0000S00000000000000C0T000000
G000000000000000000SS00C000000
000GS0000S00G00T000000H0000000
0000000000S00000000000000G0000
0000000000T00000000G000000000S
0000T000SGS00000000000000000CG
000000000SG0000T00000000000G00
00000S0000000000000S0000T00000
G000000000000000S000000000ST00
000S0000S0000T00000000000C0000
GS0000G0TS0000000000000C000000
S0000T00000000000000S0000C0000
0000000000000000G0000000000G00
