00000T0G00S00S00G000C00000C00C
000000S00000T00000000000G00000
0G0000000T0000S000000000000000
0000000G00T000000GS00000000000
00T00000000GG000000S0000000000
000T00G000S00S0000000000C00000
0000000000000000T0000000000000
00000000TSG0000000000000G00000
00000000000T00000G000000000000
000G000000T00G000000000000S000
000000000000T000000GS000000000
000000000000000000000000000000
000SG000000S000000000000C00000
00G0000000G00H0000H000000T0000
00000G00G00S000000000000000000
T0000GS00000000000S00000C0000C
000000000000000GG0000000000000
00T00G000000000G000000000S00S0
000S0T0000000000S0G00000000C00
000SS000000CG00000000C0G00H0H0
000000000T00000000000000000000
0T000000S0SG0000C000000000000C
00000000000SG0G0000000000000HS
S000000000000000S000000000000G
T00000000000S00000000000000000
00T0S000S000C00000000000C0000C
000000TG0S00000000G0S000000000
00G0000G00000HHT000000000S0000
0000000000S000000000G000000000
000000S0000T0S0000000000000000
