0S0000g00g00B000B000000t000S00
00t0000g000000g0S0000000000000
00tSS00000000000000gM0M000Mg00
0S00t00000000000000g0000000000
000000000000000g0000000g000000
0g0000000000S000000g000000BB0t
00000SS00000M000000g0g000M0tM0
00000t000000000000000g0000S000
S00000000000000000000000g00000
000000000000000000000000000t00
000S00000S000000000gt0000g0M00
00t0000000000000000000000S0000
0000000g00000000t000S0000000S0
00S00S000g0000t000000000000000
00000000000000000S00000000000g
0000000000000000S00t00000000S0
t00000000000S000S0000000000000
0S000000g0000000St0000g0000000
00000000000000g0t0000000000S00
00000000000000t00000000g000000
000000000000000000000000000000
00000000t00000000000000000g000
S0000g00000000000000000S00g000
000g000000000000t0000000000000
0g00000000000000t0000g000B000B
00000g0t0000S0000000000S000000
00000g0000000000000S0000000000
0000t00g00000000S0gB0000000000
S00000g000000000t000000000000g
0Sg000000000000000000000t00000
