0S00000T000000000000S000C00000
0000000S000G00000S000000T00000
000T000S000000000000000G000000
0000000000S00000G0ST0000000000
000000000SG0000000000000T00000
S000G0G00000000000000000000000
0000000000000000T0000000000000
00G000000T000000000S0000000000
000000000000T0GG00H00000000000
00000S0000T0000000000000000000
00T000000000000G0G000000000S00
00T000000000S00000000000000000
S0G000G0T00000S00C00C000000000
0000T00000000000S000S00C000000
00G0000S00S000000T00G00000HHC0
000000TS0000000G000000G000000S
00000000T000000000000000000000
0000000T0000000000S00000000000
00000S000T0000SC00000C00C00000
000G0000000000000000T000000000
0S0000S0C0000000000000000T0000
0000G00000000000000000TS000S00
00TS0000000000S000000000000000
000000000000000T00000000000G0G
0000TG0G0000000000000000000000
0S000T0000G0000S0000000000C000
00000000G0S0000GS00H0000000000
T00G0000G000S000000000000S0H0H
00G0000T000000G000000000000000
S00000000000T000000000000S0G00
