G000000G0000000T000S00000H0000
000000000GG0H00000000T00000000
00GT0000000000S000000000000000
T00000000000000000000G0G00H000
00G0GH00000000000000000000T000
0T0G000000G0000000000000000000
000000000T0G000000000000000000
0000000S0S0G000000G0000000000C
0000T000G00000000SG00S00000000
000000000G00000000000000000000
00TG00000G000000S00000000S0000
00000000SS00G00000G0H000C00000
000000GS0000G0000S000H00000T00
00000G000000000000000000S00000
0T00000000000000000S000000G000
000TG0S00G00000000000000000000
000000000000000000000000T00000
000000S0000G000000S0000T000000
00G0G0000SH0000ST00C0000000000
000000000000T00000000000000000
00S0G00S0C00G00000000000000000
0000000000000000000T0000GGS0H0
00GS000000G0000S0000C000000000
000T000000000S0000000000000000
0000000SG00G00000H000000000T00
00000000000G0000G000000H000000
000G0000000000S00000000T000000
00000S00T00S000000GC00000000G0
00000G0000G000000000000TS00000
00S00000S000000G000T0000C00000
