00000T00000000000000G000000000
000S00ST0G000000000000000G000H
0000G00000G00S0000000000000T00
000T0000000000000000000S000000
0T000G0000G000000000S0000S0000
0S0000G0000000T00000000G000000
0T00G0000000SS000000000G000C00
000000000000G000S0000T00000000
00000000S000000000000000000000
TS00000000000000S0000000000000
S0T00000000000S000000000G0000G
0G000GS000S000C000000000000000
00000000T000G0S0000000G0SH0000
00S00S00000000000T0000000C0000
000000000000000000000000000000
000000000G000000000000000ST000
000000G000000000000G0000000000
00000000000000G000000000T00000
00G0000000S000G000000000000000
0000T00000G0S00G0000000000000S
0G0000000T0000000000S000G00000
000G000000000000000S000G00H0S0
00SG000T00S0G000000000H0C00000
0000T00000000000000G00000000G0
000G00000000G00000SS0000000C00
00000G0T00S00G0000H00000000000
00000000000G0S0T00000000000S00
000000000000000000000000000000
000T0S0000G000000000000S000000
G0T00S0000000SC000000000000000
