0G0G00S00S0T00000000
T0000000000S00000000
GG000000T000S00S0000
0SS0G0G0000000000000
T00000G0000000000000
G00G00000T0S00000000
GT0000000S00S0000000
00G0S00000G000T00000
000G00000S0S00000000
000SS000000G00000000
GGS00T00000000S00000
0TSS00000G0000000000
00000TS0000S0000G000
S000000000000G000000
0000000000G00T000000
S000000GGS0000000000
00S000S00T0000000000
S0000000000G0T000000
T000S000S00000000000
0000000000000SST0000
