000000T00000G00000000000000000
000000000000T00000000000000000
000000000000000000000000000000
0000T0000G00000000000000000000
0T000000000SS0G0G00H0000000000
00000G000G000H00HS000S00T00000
0000000000000000SS000000C00G00
00T000000G0000000000G0SH000000
00000000000000000000000000000T
0000S0000000000000000000000000
000000S0G000000000G0S0H00C0000
0000000000000T000000000G000000
000GS0000000000000000G00000000
000000000000000000000000000000
00000S000G00000000000000000S0G
0T000000000000000G0S00000000GH
00000T00000S000G000G0000000000
000000000000000S0S000000000000
000000000000000000000S000T0000
000000T00GS00000000000GH0000S0
00T000000000000000000000000000
00000S0000000G0T00000000000000
0T00G00000GH000000000000000000
00S0G00G0000S0000000000TC0CC00
T00000000000000000000000000000
T0000000000G0000000G000000H000
00000000G0000T00000000000000S0
00000G00000T000000000G00000000
0T00000G0000000000000000000000
TG0GS0000000000000000000000S00
