000000STG0000G0000000000000000
0S0000000T000000000000SCG00000
00000S000000000000G000G000T000
0000S000000000000000000000000T
000000000000000T000S0000000000
00000000000000G00GS00000SH0000
0000000000000S00G000000T0000G0
0G00000000000000T0000000000000
000000G00000000000000000S00S00
00000T00SS000000000000000000G0
00G0000000G0000000000SS0000000
000000G000000000000G0000000000
00000S000SCTG0000000000G0000H0
0000000S0000000S00000000000000
00000000000000000G000000000000
00S0000000000000T0000000000000
000G000000000G000000000000TSH0
S000T00000000000000000000G0000
00T0G0000SG0000000000000000000
0000000S000S000CG000000C000000
00000T00000000SSG00000C0000000
00000000000000000000000G000000
0000000000000T0G00000000000000
S000000G00000T0000000000000000
000T000000000000000000000000S0
000000T0000000000000000S000000
00S000000000000000000S0C000G00
0000000000T000000000000S000000
000G0000SS00000000000000000000
0000000GG000000000S00000000000
