0000S00S0C0C000000000000000000
00T00S000000000000000000G00000
0000000S000G000000000000000000
0000000000G0000000000S000S0GT0
0000ST00000000000000000S000000
0000000S00000000000000000S00T0
00000S00000S000000000000000G00
T000000000000000000000G00000G0
00000000S000000000T00000000000
0000S000000S0000000G00000C000G
GT0G00000000H00S000H0000000000
00000T0000000G00000GS000000S00
G00G00000H00000000000000000000
00S00000G000000000000000000000
00G000G00H00000000000000000H00
00T0000000000000000000000000S0
000000000000000000000000000SS0
S000000000T0S000G000C000000C00
00GTS00000000000SC000G0H0000C0
0T0000000000000G00S00000000000
00G00000G0000000SS000000000000
00000000000T000S000000S0000000
0S00T000000S0000000000C0000000
G0G000000000S00T00000000000000
000000000G00G00000000S00000000
0000000000000S00000G00000S0000
00000G000000000S00000000000000
00GS00000000000T0S000000000000
0000T00S00000000S0C0000C000000
0000000000S0000000000000000000
