00000T000000000000000000G0000S
000000000000S000T00000000G00S0
S00000000000000T00000000000000
000T00GG000000H000000000000000
0000S0000000000000000000000000
S00000000000000G00000000000000
000G00T0000000000000G0000S00H0
000T00000000GS00000000000000S0
0T00000G0G00S00000000000000000
000000S00GT000000000G0000H0000
T0S00G00000000000000G000000S00
T00000G00000000000S00000000000
00000S000000000000000G00000GST
00000000T0000000S000000000G000
000T0000000S00000000G00000G000
00000ST000000G0000000000G00H00
S000000GS0C00000T0000000000000
G0000000SG00000000000000000000
G000000T0S00000GS00000C0000000
00000G0000000G00000000S0T00S00
0000000T0000000000000000000G00
000000000T000000000000000000S0
00S0T00000000G0000000000000000
000000000T0000000G000000000000
00000000000G000000S0000000000T
0000G0000G000000000H0000000000
00G000T000000SS0G0C00000000000
0S00000000000000000000T0000G00
0T0000000000000000000000000000
0000G000000S0TS000CG0000000000
