00S0G0000G00T0000000
00000S0000G0G0000T00
0ST000S0000000000000
0TG00000000000G00000
00S000G000T000000000
0000S0000000T0000000
0T000000000000000000
0000S00000G0G0T00000
00S00G0000S0000000G0
0000T000000S00000000
0S0S00000000T0000G00
000000SS00G00000T00G
00000G0000T000S00000
0GG0S000000T0000S000
S0G0000000T000000000
T0000000G000000S0000
TG000000000000000000
0GSG0000000000000000
0000SS0000000G0G0000
0000000S0000000000G0
