G00S000000000000000000000000G0
0000000000TS00000000S00000000C
0T0G00000000G000H000000H000000
00000S000000000000000000S0C000
000000G000000000000S0G00000H00
000000000G00S00000000000T0000G
0000G000000S0000000000S0T00000
0000000000T000000S0000000000SG
T00G000000000S00000000000000G0
0000000G0000000000000000000000
0000000000000000000S00G0000000
0000T000000000000S0G00S000000C
00000000G0S0000000000000000000
0000000000000GG000000H0H000000
000S00000T00000000000S00000000
00T0000000000S0000000S0CC00GC0
00G0000T00000000000S00SG0000C0
00G0000000000000G00000000S000H
000000000000000000000000000000
00S0S00000G0C000C0000000G00000
0S0000T0000S000000000000000000
0S00GG00000000000000000000T00H
00G000S0T000000000000000000000
S0000000000S00000000T0000000G0
S0G00000000G000S000C0000000000
00000000000000S00S0000T000000G
00000000000T00000000000000G000
000S0000G000S00000000000C0000C
0000S0000000T00000000000000G00
0G0000000000000000000000000S00
