00000g00000tg0000000B000S00000
S00g000000S0MM0000000g00000000
00g00S000000000000000g00000000
0g000000000g0000000BS000000000
00000S0000g000g0000t0000BB0000
000tg0000000000000000000S00000
0000000000000000000t0000000000
0S00000t000S0M0M000000000000g0
0000000S00000g0000000000000000
t0000000000S00000000000g0S0g00
g000S00g0000000000St0000000000
00000g000000000gB00000000B0000
000000000000000000000000Stg000
00000g0t00000gS000000000000000
000000000000t000000000000000S0
00000g0g00000B00000t00000000S0
000S0000g0000S00000g0000000000
t00000000000g0Sg000000B0000000
0000000000000t0000000000000000
00000000g0000gS0000t0000000000
00t000000000000000000000000000
0t00000000000S0000000S00000000
0g0000000000000000000S00000000
0000000000000000tS00000g00000g
0t0000000S000000000000000000g0
0000S00S000t0MM0000gM00000g000
000000000000000000000000g00000
gg0S00000000000t00S00M00000000
000t000000S0000000000000000000
S00S00000t00000000000000000000
