000000S00000000000000000000S00
00000G0000000S0SG0000000000000
000000000T0000000000G00000000S
000000000000000000000000000000
0000T0000000000000000000000000
0000T0SS000M00G0000000M0000000
0S00000SM00000T0MM00M000G00000
00S00000T00000000000000000G00S
0000S000000000000G000000G00S00
000G0S0000T000000000000000G000
00000T000000000000000000000000
00000000G000S00000000000000000
00S0GT000G0000B00000000000S000
000G0000T00000G000000000000000
00T000000000000S000000S0000000
00000S000000000000000000000000
0S0S000000000000G00G0000000000
00000000G00G0000T0000000000S00
0T00000000S00G0000000000000000
000S0000000G000G00S0000T000000
0000000T000GG00B00000000000000
0000T00G00S0S000000000M00M0G00
00G0000000T00000S00000000G0000
00000000000S0000000000T000000S
S0S0000000T0000000000000000000
0G00G000000S0B000S000M000000B0
S0T0000S000000G000000000000000
0000000000T00000S0G00000000000
00000T00G00S000000000000000000
00000S0000000000000000000000T0
