0000000GT0000G00B000000B000000
000000S00000000000000000000G00
0000000000G0000GB00000ST00000B
00G00000ST0000G00S0B0000000000
0000S0S0M00M00G0G000T000B00000
0TSG000000000000S0M00000000000
0000000T000000000GG00000000000
0000000000000000000000T0000000
S000000000000000000000000S0000
0000000000000S00T00000S0000000
00G00000000SG0000000T0S00000M0
000000000000S00000000G000G0TB0
0T0000000000G000G00000000B0S00
00000S00S00000M000G00GT0000000
00000000T00S000000000000000000
00G00000000T00000G00000B000000
00G00000000000S0000GT0000S00MB
000G0000000000G00000S000000000
00000000T000000000S0000000G000
0000T0000000000000000000000000
000G0000000000000G00S000TS0000
G00000G0S000STB00000000M000000
000000000000000000000T0000000G
00S000000000000G00T00000S00000
00GG0000000000000000000T000000
G0000000T00000S000000000000G00
00G0G00000000000000000B000000B
0G000G00000S000000000000000000
0000G0S000SM000000G00000000000
G0G0000000S00T000000000B000000
