00000GT000000G0S0000
T0000000000000S00S00
G00T00S0000S00000000
0000GT000G000000S000
00000000000TG0000000
0000000000G000000000
00000TG0000000000000
S000T0000000000000SC
00000S00000ST0000000
000S0000SC0G00000000
000000000G00S000000T
0000000G00000S000000
0S0000000GG00000S000
T0000G00G00S00000000
S000T000000000000000
0G00G0000000000S0000
00000S00T0000000G000
TS000000000000000000
000G00S0TG0000S00000
00000G0GT00000000000
