00T0G0G0000000H000000000000000
0T00000000000000000000G0000000
00S000000S000000000000C00000G0
0000000G000000000T0000G0000000
0000G00000000000T00000000S0000
0S0S00000000G000000000T0000000
00G0T0000000000000000000000000
000000G000SG000000H00000T00000
0000000000000000000000000GG0S0
00T000000000000G00000000000000
0STS000000000G0000000000000000
000000000000G00000S0S000000000
0000000000000T0000S00G0G00000H
00000000G000000G000S0000000000
00000S0000000ST000C00000000000
000000S0G000S00000000T00000000
0T00000000000000000000G0000S00
0G00000000000000000000T0000000
G000G0S0000000000000000S0000C0
GG0S000T00000000000000000S0000
G0000000GS0000000000000SH00000
0000S00000000T0000000000000000
0000000000S00000G000T0000000S0
00S0000000000000G0S0000000000T
00000T0000000G000000000G000000
000000T00000000000000G00S000G0
0000G00000S0000T0G000000000000
000000000000G0000000S00S0GH00C
0000000S000S00000000000000000C
000000S00000000000000000000000
