S0G00S00000000000000
0000000000G0G0000T00
G00000T0000000S00G00
0G0G000000000T000000
0T0G000S00G000000000
T0000G000000000G0S00
000S00000T000000S000
000S0000T00000G00000
G00S000000000SG0000T
00000S00000000000T00
S0T000G000S00000000G
0000G0S0000000T000G0
000G0G00S00000000000
000000T000000S000000
00S0T0S0000000000000
0000000000000000SS00
00000S0000G000000T00
G0T0S00000000S000000
00000000000G000T000S
0GS000000T000G000S00
