0G000000G0000000000000S00000H0
00000000G000000000000000000000
T000SG000000S00G0000C000H00000
0000000T0000000000000S00S0000G
000T00000G0000S0S0000C000000G0
000000T0S0000SC000G00000000000
0000000T00000000S000S0G00000C0
000000G0T000000000000000000000
000SG0T00000000000000000000000
0000G00000S000000000000000000T
0000G000G000000000000000T00000
0SS00000000C000000000000G00000
000S000000000S0000CG0000000000
00S0000S00000CT0000000000000G0
00000000000000000T000000000000
S0000000000000000000000T000000
0000000000000T0S00000000000G00
00G00000000000000S0000000G0T00
000T000GG00S00S00HC00000000000
000T00000000000S000000S0C0000G
T000000000000000000G0000000000
00000T0000000G0000000S00000000
0000000000000000T0000000000000
00000T0000000000000000S00000G0
00S000S0000G0C0000000G000000T0
00000000000000000000000T000000
0S0T00000000000000000000000G00
00000T0000G0000G00000000000000
0000T0000SG00000000G0000000000
000T0G000G00S0000000000000000S
