0000tg00000000000g00000B000000
0000t000000S00000S000000000000
00000000000S000000000000000000
0t000000000000000000000S00000S
00000000000g00000000g0t00000S0
00000000g0000000S000t0000S0000
0000S0t000000000S0M00000000000
000t00000000000000000000000000
0000000000g0000000000t00000000
00000000000t00000000g000000000
0000000000000g00000000000000t0
t00000000000g000000g0000000000
SS0000g00000000M0Mg0t00000000B
0g000000000000000g000Bt00B0000
00000000000S000000000000000000
00000000000000000g0000g0000000
000000tgg00000000000S000000000
0000tS00S000000000MM0000000000
00S000g000000000000000S000000t
S000S0M00000000g00000000000000
000g000000000000000S0000g00000
0000g00000000t00Sg0B0000000000
0gg00Bt00BS000SB0M000000000M00
000000g0000000000tS00000000000
0000000g00t000000000g00SS000M0
0000000000t00000S0000000000000
S000t00000000000000000g0000000
00g0t0000g00000B0000000000B000
00000000000000000t000000000000
00gS00000000000t0000S000000000
