t000000000000000000000S0S0000g
0000S0000000000000000t000g00S0
00000S000000000S000t00M0g00g00
0000000St000000000000000000S00
0000000000g00000000000t000g000
0000000000000000000000000S0000
00tg0000000000g0000000S0B00000
000000000g000000000t0000000000
0000000000g0S00000000000000000
t00g0Sg000BBS000B00000000B0000
0000000000000t0000000000000000
00000S00000000000000S000M000g0
000000t00000000S000000S0000000
00000000000000000t00000S000000
0000S0000t000000Sg000000000000
0g0g00000t000000000000S0000000
00t000S000000000000000g0000000
000000S00000000000000000000000
0000g0000000000000000t00000000
000000000000000t0gS000S0000000
000000g0000g0St00000000SM00000
00000g000000000000g00000000000
0S00000t0000000000g00g00000B00
000000000000000000000000000000
gS000000000tg0B0000B0000000000
0t00S0000000g000g0000000000000
000t0000S000000000gg000BS00000
t0000g00000000000gB0B000000000
0gS000000000000gB0000000000000
00S0000t00000S00M0000000g00000
