0000T00GG00H0000H0000000000000
0000S0000000000000000000000000
T000000S0000000000000000000000
0GT000000G0000000000000000000S
00000000000000000000000S000000
0000000000000G000000000S0000GS
0000000000000GG00H000T00H00000
0000000000000000000G000000000T
00000TG0000000000S00000000G00H
0T000000000G0G00000000000000H0
00G00000000000000TG00000000000
00000000000000T00S00S000000000
T0000G0000000G00000H000000000S
000000000000000000000S00000000
0000S0G0000000000S000000000GC0
0G00000T000000000S00000000GS00
0SG000000G00000000S0000000000C
0000GTS0S000000000000000C000G0
00000SSC00000000000000000000T0
0G00G0000000S0000000H000000000
00S0000000T0000000000000000000
0TS0000000000000000000S0000000
000S00000000SG0000C00000000000
000G000000000000000000G0000000
00T0G0000000000000000000000000
00S0000000000S00G00000C000T000
000000S0T000000000000000000000
00G0000000TS00000G000000H00HH0
0000000000G00000GH000000000SS0
00000000000000000G00G000000000
