TG000000000000S0S000
S00GG000000000000000
0000000000S00S00T000
00000S00000T0000000S
0G0000G000000S000000
00000000000S000000T0
000T00000GS0S0G00000
0000000000G000T0000S
TSS00G000000000000C0
0T0000G0S0000000G00S
000TS0000S000000000C
0T00000000G000000000
00T000000000G0000000
T0000000G00000000000
00T00SS0G00C00000000
000000000S000G000S00
00T00000G00000000000
000ST0000000S0GC0000
0S00000000TG00000S00
T00000000000000000G0
