0000000000S0000000000S00000000
0000G00T0000000000000000000000
00T0000SG0000000G0000000000000
TG0000000000000000000000000000
000G00000000000000000G0000000S
00000T0000000000000S0G0000S000
000G00G00SSH000000000000000000
00S000ST000000000000000000000G
000GT0000000000000000000000000
00T000000000G0S00G000000H00000
00000G000000S00000000000000000
00G000T000000000000G00H00000S0
0000S00G000000T000000000000000
0000000TG00000000000000G0H0000
000000G000000S0000000000000000
000G000000000S0000S00000T00000
00000000000000GT000000S0000000
000S00000T0000000000000G00S000
000000000ST00000000000000G0G00
G00S0000S0000000T0C0G0H0000H00
000000000T000G000G000000000000
00000000000000G000000000000000
0000T000000000000G00000G00SS00
T0G00000000G000S000000000000SC
S0000GT000000000000S0000000000
00000S00G0G000000000000000000H
00S000000G00000000000000T000G0
000000000000000000G000000G0H00
00000G00G0000000000H00000H0000
0000T00000000000G0000000000000
