00000000000000000000
0000G0G00000000000S0
00G000000000T0000000
S0000S0G000T000G0000
T000000S000GG0000000
00000T000000S0000000
000GT0000000S0000000
G0GT0000000000000000
00000000000000000T0S
00000000S0000S000000
000000000S00S000000C
00000000G00S00G0T0S0
T0000G000000000G0S00
0G00S0000000000S0G00
T0000000000000000000
000T000S00000000G000
00000T000G0GS00S0000
000T0000000000000000
G00ST0000S0000G00000
000000000S000000T000
