000000T0000000000000
0G0000000000S0T000SG
S0T00000000000000G0S
00000T000000000G0000
00G00S0000000000000G
S000S0000000G000G000
0000T000S00S00000000
S000GG0T000S00000000
0000000000000000000G
T0000000S00000000S00
S000000000000000000S
00T00000000000G00000
GG0000000T0000000000
0000000000G00000G000
0G0G00000000S0T00000
00T0000G00G000000000
0000000TG00G00000000
000000G00S000000000G
0000GGS000000T000000
000000000T0000000000
