T000000G0000000G0000
T0000S0000G000000000
GT00S000000000000000
G000SG0000000000T000
S0G00GS0000000000000
T0S000GG0000S0000000
T000000000S000G00G00
0G000000000000000000
0GS00000000T00G00000
00G0000000T00G000000
00T00S000S000000000G
T00S0G0000000S000G00
000S000000S000T00000
00T0000000000000G000
00TS00000S0000000000
TG000G00000000000000
G000S0000000G00T0000
T00000G0S0G000000000
0000T00000S0000G0000
000ST000G0000G000000
