00G0000000S00T00000000000G000H
0000G000000000000000T000000000
000000000000000000S00000G00000
000000S00000000000000G0S000G00
00000000000GG0H000T0000S000000
00000000ST00000000000000000000
000000000000G000000S000000G000
000000000GGS0000H000000000T000
T00S0000000000000000000000000G
00000000000000S000T00000000000
0000000S00000000000G0000T00000
000T00000000000000000000GG0000
000T00G000000GSH0S0000000H0000
000T0S000000000000000000000000
00000000S000000S00000000000000
00000000000000G0T000SS00000000
00000T0S0000000000000G0G000000
0000000T000000000SG0000GH00000
S00000GG00000000000H0000000000
0000000S00000000T0S00000000000
0T0000000000000000000000000000
00S000S000000000C0000000C00000
00000T00000000000000000000000G
000S000000000000000000G00000G0
T000G000S00000000000000000G00S
0000000000S00TG0G0000000H00S00
00000000G000000000000000000000
00000000000T00000S0000000000G0
00S00000GT000G00000000000S0000
0G0000000000000000000000S000S0
