0000S00000S00t000M000M00000000
000000000000000000000g00gB00B0
0000t0S0000000000000000000S000
g0000000000S0000S00000000000t0
0g0000g00000000B000000000S0000
0S0S00000000000t000g0000M0M0M0
000000t000000000000Sg000000000
00000gg000S000SM00000M000000M0
0000S0000000000t0000S00000g000
000g0000t0000000000000000000S0
000000000000tg000S000000000000
000000000000000t0S0000S00000g0
000gS0t000000000000000000g0000
S000000S00g00000000gt000000000
00000000t0g0000000g0000B000000
0000S000000000000000S000gg0B00
0000g0000000t000000SgS00000000
00000000000000000000S00000Sg00
000000t00000000000g0000000S000
0000S000t000000000000000000000
0000000000000000t00000000S0000
t0S0000000000S0000M00M00000000
t00000000000S00000000000000000
0S0t000000000000000000S0000000
0S000t000000000000000000000000
000tgS000000g00000000000B00000
t00000000S00g00000000000000g00
gt0g00000000000000000000B00000
t000g0000000000000000000000000
00S000000000g00000000000000g00
