0000Sg0tS00000000000000000000g
00000t0000g000000000000000000g
0S00000S0t000000000000M000M000
0000g00S000000000000000t000000
0g000t000S0000000000S000000000
000000000gSg00S0000M0000B00000
000000t00000000g00Sg0000000000
000000000000SS00000M00g0000M00
00000000g000g000000000000t0000
00t0000g0S00S0g000000000B00000
000g00t0000S00000000g000000000
000g0000000000000000t000000000
0000000g00S00000000000t0000S00
0S000000000000000000000t00S000
0000t000000000000gS0000000S000
00000000000000S00000S000M0t000
0t00gg00000000000000B000000000
0000000S0000Sg00g0000000000000
000000000000000t00S000g000SM00
000000000000gS0000t00000000000
000000000S0000000000000000000t
0000S000000000000000g0000S0000
00000000S0g0000000000000S0000t
00g000000000000000000000000000
0000g00000000000tS000000000000
0000000000000000t0000000000S00
000g000g00B00BB0S000000t000000
0000t000000000000000000000000S
0000000St000000000000000000000
S0St0g00000000g000000000000000
