0000000S0S0000M000M0T00000M000
000S00000T00000000000000000000
00TG00000000000000000000000000
000000000000000G000S00000S0000
0T0000000S00000000000000000000
00000S00G00T00S00000000M0M0000
000000S00T0000000S00G000000G00
0000S0000000000S00000000000000
0000000000G00000000000G0000B00
00G0000S0000G00000000000T00000
0000000G0000S00T00000000000000
0S000000000S00000000000000G000
000000000000000TS00000000000GS
0000000000SGS000G0M000T0B00000
T00000000000G000000000G0000BS0
G000000000G0000000T00000000000
0GG0S0S0T000M0000MB0000MB0B000
00000000T000000G000000000G0S00
00T0GSS000000G0000000000000000
0000S0000000000000S000G0000000
0000S00000000S0T0000G00MMG0000
00T0000S0G0G000S00B0000MM00000
0000000000000SG0S00G00T0M00000
000S0000000000000000000000T000
000T0S00S0000000000000000M0000
000000000000000T00000000000G0S
000000000000000000ST000000G000
T0000S00S000000000G00000MM0000
0000000000G0T0S000000000000000
00000000000G0000000T0000S00000
