00G0000T0S0G00S00000
0000000000000T00S000
0S0000T00000G00G0000
S0000000000GT000S000
000GG000T00000000000
00GS00SG00000000T000
000000000G00S0000000
000G0000000000T00000
0G000000000000000T00
000000000T0000000000
0000000G000000000000
0S00000000SC0G0000T0
0000G0SS0T000C000000
0000T000S00S00000000
000000000T0000000000
0S0G0000000000000000
T00S000S00000G0C0000
0TG00000000000000000
00S00GS00C0TG0000000
0T000S00000000S00000
