00SS000C0T0000000000000000C000
T0G0G0000000000H0000000000S000
000S000T00000000G00000000S000C
000T00000000000000000000000000
000000T00000S0000000S000000C00
0000ST0000000000G00000000000S0
00000000000000T000000000000S00
0S00000T0000G000G0000000000000
0S0000000000000000000G00000000
000000000T0000000000000G000000
0000000000000000000000000G0T00
0G000000G000000000SS0T00000000
0000000000G00G0S0H0HS000000000
00000000000000G00G000000000000
0000000000TG0000000000000000G0
00000000T0000G0000000000000000
000000T00000000000000000000GG0
0000000000T000G000000000000000
0000T00000G000000G0000000000H0
0T00000000000S0000000000000000
00000000S00G00000000000000G000
0000G000G000000000000000000000
00T0S00000000S000G000G00000000
0G0TG00000000000000000H0000000
00000TS000000G000SC00000000000
0000G0000000S00G00000000000S00
00G00000000000G000000H0000000S
000S00000000000000000000000G00
000S0000000G0000000000000000G0
000S00000000000000000T00000000
