000g000000000t00000000000S0000
00000000S0g00g0S0000000t000000
t0g000000000S00000000000000000
00S00tS000g00000000000g0B0000B
0t0000000000000000000000000000
0000000000000S00S0M00g00000000
gg0SS0000Mt0000000000000B0000M
0S000000000g000000000000000000
00S0000g0000S00gB00000t0BB0000
00000000000000000000000000g000
0000000000ggt00S0S000000000000
0000g00000000000000000t000000g
0000000000gS000000000t00000000
0g000t00000000000000000000S000
00000t00g00g00000B000000B0B000
0000g00000000g0B00000000000000
t0000000000000S000000000000000
t000g00g0000000000000000000000
0000t000000000g000000000000g00
0000tS0000S0000000000000000000
t0000000000000g000000000000000
0000000000000000000000g0000000
0000t00000000000000000g0000000
0000000t0000000S0000000000S000
000000t00000000000000000000000
t00g000000000S0000000000000000
0000000t00000000000000g0000000
00000000000000t000000000000000
0t0000000000000000000S00000000
00g00000000000000000S0St000000
