00000GT0000000000000
00000000G000S0000000
000S0T0000G000000000
000000T0000000GS000S
T000000G00000S000000
000T0000000000000S0G
00000T00G0000S000000
00000G000ST000G0000S
0000000000T000000000
S0000G0000T00G000000
0000000000000GT00000
T000000000000S000000
0T000000G0000000G000
SS000000000000G00000
00S0G000G000000T0000
0S00G0000000T0000000
0T0S0000000000S00000
000SS00G00000000G00T
000000ST0000000S00G0
T00S0000000000000000
