00000Stg00000000g000000000S000
00S0000000S000000000000gM00M00
0t0000000000000000000000000000
00000000000g000t0000g0000S0000
000000t00000000S00000000000000
000000000000000g00000000g00000
gS00000g0000000000000000000000
g00g00000000000000000000000000
000000000g00000g00000000000000
00000St000g00000g0000000000000
00t0000000000S0g0g000000000000
000000000000000000000000t00000
t00000000000S00000000S00000000
00t00000g000000000000000000000
0000000000g000000000S00S000t00
00000t000000000000000000000000
000000000S000S000gM000t00000M0
0S00000000t0g000000S0g00M0000B
S0000S0g0000M0000t00g000000000
00000StSg0000000000000000000M0
g0S00000000000000000g00000000B
g00Sg0000000000000000000000000
0000000000t00000000g000S0S0g00
0S00000000000000000S00000000Mt
0tS00000000000S000000000000000
t00000000g00000000000000000000
00S00t000000g00000000000Sg0000
0t000000S0000000g0000gS0000000
00000000000g000000000g00000000
00t00g000000SS00M000000g000000
