00000000t000000000000000000000
S00g0000000000000000000000000t
00000t000000000g000000000g0000
000000t0000000000000000000S000
0S00S000000MM0000000000g00000g
0g0000gt000000S000000000B00B0S
0S00000000tS000000g00000M00000
00t000S0g000000gS0M0000MB00B00
0S00000000S00000000000M000M000
0000000SS000000000000g0000t000
0000000000g00S0t00000000000000
0000000000000000g0000g00B00000
0g0000000000S00t00Sg00000M0000
00000000S00g0t0000000000000000
0tg00gSBB0000000B0B00000000000
0S000000000000000000000000t000
000S0000000t00000g000S00gMM000
0S000000S00000000M0M0000000000
t00000000000000000S00000000000
0000000000000S00000000g0000000
000000g00000S0S000000000000g00
0000g0gS0BtS000B0000000000000B
00g0000gt0000B000000000000000B
gg000B00000000t000000000B00000
0000000000g000000t0000S0000000
0000000000000g0000000000000000
0000000000000t0000g00000000000
000000000000000000000000gt0000
0000g00000S000S000000000000000
00000000000000gg00000000000000
