0000000000000g0000g00000000000
000g0000000000S0t00Sg0M0000000
g0S000t00000S00g00000000000000
00000g00tS0000000g0000B0000000
000t00S00000000000000000000000
0g0S00000000gS00000000000B0000
000000g0t00000S000000000000g00
00000000g000000S0S00000tM00000
0000S00000000g00tS0000000000M0
00000t00000000000000g000000000
000ggS0t00000000000B0S000000B0
0000000000g0t00000000000000g00
0g0t000000S0S0M0000000g0000000
00000000t0000000000000S0000000
g0000t000000000000g00000000S00
0000g0t00000000S00000000000000
0000t00000000000000000000000gS
000tS000g0S000000000000000gM00
0S00000gg0000000S0000000000000
0g0000000S00000g00t00000000000
0000000000000000S00S000gt00000
S0g000S000000M000t000000000000
g0000000000t00000S000000000000
00g00000000S0000000000000000S0
0g00000g000000S000tS0000B00000
0000t000Sg00SM0000000000000000
S00t0000g0000000g0000000000000
000000t000g00S000S000000000000
g00000g00000000S00000S000000t0
000000000000000g0000000g0000tS
