0000T000000000000G000000000000
0T00G00000000000000000000G00S0
0T0000000000000000000000000S00
0000000000S00S00000000M00T0000
0000000000000GS000G00000000000
00000T000000000000000000S00000
0000S0S0G00M0000G0000000BB0000
0000T0000000000000G00000000000
TS0000000000G00000000000000G00
0000000000S0S00TG000000G000000
0000000000000000G000S00T0S00G0
000T00000000000000000000000000
00S0000000S0000000G00T00000000
T00000000000G00000000000000000
0G0G0B00000000B0000TS0S0000000
000000000G00000000000G00000000
T0G0G000000000000000B00000S000
0000000000000000S00TG000000000
0000000G0000000000S0T000000000
0S0G000000T00000000000S0000000
0S0000S00000000M000M000000G0T0
0S0GG0000000000S00000000000000
000000000000000T00000000000000
00S0S0000000000000000000000000
ST000000000000S000GM00000G0B00
0000S00000T0000000000000000G00
000G0T000000G00S00000000B0S000
0000GSGS00000000000T0000000000
000T0G0000000000000000000000S0
00G0T000G0000S0000000000000000
