0000000S0000GS000000
0000S0G0000T0G00S000
00000S00000000G0000S
000S0000S0000000000T
G000T00S00000000000G
000G0000000000000000
00000000000S00G00000
S0000000000GG0000000
00GS000000000S000C00
0000000000000000T000
00S0000000000000S000
0S0T0G000000G0000000
0G000000T0000S0S00G0
00TG0000000000000000
0S000000S0000G0TC000
000000000G00000000T0
000T000S00SC000000G0
G00000S0000000G00000
0000G000000000000000
S00T0000000000000000
