T0000000000S0SG00G000000000000
00000000000S000000000T00000000
T00S000000S0M00000G00000000000
00000G000000G00000S00000000000
0000000G00000000T0000S0S0G0000
00000000000GG00T0S0000000000S0
0G00T00000S0G0B000000000000000
0000000G00S00000000000000G0000
00TS00000000000000000000000000
000S00000000000T00000000000000
0G00000000S000000GSB0M0000B000
00T00000000000000G000000000000
000T00G00000S00000SG0B0000B000
0000TS00G0000G0000000000000000
000000GG0T0000000B00S000000000
T00000000S0000000000000S0000G0
SS000000TGG000000M00M00M000000
00000T0000G0000000S00000000000
00000000000T000000S0000000S000
G0T000000000000000000000000G00
G000T0S0000G000000000000000000
000000G00000000S00000000000000
000000T00000000000G00000000000
00GST0000000000000000000G00000
00T0S0SM0000000000000000000000
00000000G0000G000000T000000000
0000000000000G0G0000S000TB0000
000000G00000S00G0000000T000SB0
0000S0000000000SG0000000000000
00000000000000000000000GS00000
