0S0000000TG000000G000000000000
000000S000000000000000000000GT
S000GG000000000B0B00000B000000
S0000000000000S0000M0000T00000
00000000000000S000000000S00000
000000000000000000000000000000
00000T00000G000000S0000G000B00
000000000000GG00000000B0000000
000000000GGB0000000000B0S00000
S000T000000G00S00000000000000G
00000000000G000000000000000000
GS0000000T000000000G0000B00000
000000000G0000000G00B0000000T0
S00000000000TS0000000000000M00
00000T000000S0000000000G00000S
0000000000000000S0G0000G000B00
000G000G0B0S0T0S0000000000M00M
0SS0000M00T00000000000000000M0
00000G00S00000SM000000M0000000
0000000000000000000000S0000000
000S00SM0G0G00T0000000000000B0
0000000000T000000000G0000G0000
0000000000S0000000G0G0000B0000
00000TS00000000000000000000000
T0000000G00000S000000S00000000
00000000000000GT000000000000S0
G0S00000GB00000000000000000000
0G0T00000000000000000000000000
00000000000000T000S00000000000
000S0T000000000SG0000000000000
