00000G00000000G000000000B00000
00S000000000000000000000000G00
00000000000000T00000000000GG00
0G0000G0000SB0000000S00B000000
00S0GG0000S0000000T00000000000
0000G0000000G0000000000000S000
0000SS00000M000000TM0000000000
00G00T0G0000000000B00000000000
00000T00G00000000S0G00000S0000
0000000000G0000000000000000S00
0000G000G000000S0S00B0B00000B0
00000G0000T0000000000000000000
000T00S0000000000000000000000G
00000000000000G000000000000000
0000T00000000000000000000000G0
0000000T00000000G0000000000000
000000000000000000GT000000000S
TS0000000G00000000000G000S0000
00T000000000000000000000000000
0000T000000000000000S00000G0G0
0000000000000S0000000000000000
000G000000000G0000000000000000
000000000000T0000000000000000G
S000000T0000000G0000000S000GB0
0000000000S000000TG000000000S0
000000GT000000000000000000000S
00000000000S0S00M000000T000000
G000000000G0B00000TS0000S00000
00000000T0G000000000000000000S
00S000000000000000000000000000
