g00g0000B000B0000000000000SS0B
00000000t0S000S000000000g00000
0t00000g0000000000000000000000
S00gt0Sg0000B0M0000000000M0000
g000000000000S000000S000000000
t000gSgB0S0000M000000B00B00000
00000000St00000000000000000000
0t00S0000000000000000000g00000
000t0S0S0000000000000000000000
000t000000g00000S000000S000000
000000000t000000S0S00000M00000
000000t0S0g00S0000000g0000M000
0000000000S000000000000000ggBB
00000000S0000000000000000g0000
0000000S0S00t00000000000000000
0000000000000000000000000t0g00
00g0000g0000000000000000000000
000S000000000S00000g000000000M
0S00000t0000000000000000000000
S000g000000tgS0000B00000000000
000000g00000000000000000000000
g00000000000000000000000t00000
t0000S00000gS0000000g000000000
0000000000000S0g0000S0t000g000
g000000000t0000000000000000000
000t00000000000000000000000000
000000t000000Sg00000000000000g
000t00000000000000000000000000
000000Sg00000g0000S0000M0000t0
0g000t000000000000000000g00000
