000000000000000T00000000000G00
000000G0S00G00000T00000000H000
S0000000G00000ST0000G000000000
0000000000000S00000000G0TS0000
00GS0000000000000000000TS00000
S000ST00C000G000000000000G0000
000T0000G0S00000000000000S0000
0000ST000000000000000000000000
0000000000000000000000000000S0
00000000000000000G0S0000000000
00000TG00000G000H0S00000000000
00G0000T000000GS000S00H0000000
0000000000T000000000000000S000
000T00000000GG00000000000HS000
GGT00000000S000000000000000000
000T000S0000000000000000000000
0000000SS00C00000000000000G000
000000000G00000000S000G00000T0
0000000S000000T00G00000G000000
000000S00000000T00000S00G00000
T00000S0S000C0000000000G000000
0000000G00000T00000S0000000GH0
0G0000000000S00S00000000000G00
G00000000000000000T0S0SG000000
S00G0S00000000000G00C000000H00
T00000000S0000000GS000C0000000
000000000T00G000000G0S00000000
0000000000T0000000S00S00C00000
00G0000000000T000S000G0H000000
000000000000000G00S00000000000
