00000S0000000000000000G0T0S00G
000000000G00T00000000G000000S0
00000000T0000S0G00000000000000
00G00000000000S000T00000S00000
000T0000S0000000000000000S0000
T000000S0000G0000000000SG000H0
0000000000T0000S000000000000S0
00000S0000S000000000G0000000C0
00STS00000000000C000G00000C00G
000G00T0000000000G00H0000HH000
0000000G00G0S000000000000S0000
00000000T0000G00000G0000000000
0000000S000S00000000000000C000
00000000G00000000000GH0H000T00
000G000000000000000G0000000000
00000G0000000S0000000000000000
000000000000000000000000000000
00000000000000000S000T0S000000
STS000000000C00G000000G0000000
0T000000000G000000000000000000
000000SG00S000000000G000000000
00000T000000G00000000000000G00
0000000000000000S0000000000ST0
00000000000T000000000000000G00
000000000000000000G00000000000
000000G00T00000000000000000000
00000000000S0T0000S00000000000
0000000000G00000000S0000S00000
000000000G0000T0S0000000000000
00S0000G00000S0000000TG0000000
