000000000000000000000000000000
00000G000G000000000000000T0000
00000000GTS000000000G000000000
000000SS0000000000C00000000T00
000000G0000000000000T0000S0000
00T000000S0S0C0000G00000000000
0T0000000000GG0H0000000000000S
0000000000000000000000T0000000
0T0G000G0S000000000H0000000000
00000S000000000000000000000000
0000SG00000000G000HT0000S00000
G00S0000000000T0S0000000000000
ST0000000000000000000000000000
0000000000GS000S00000000000T00
0T00G0000000000000000000000000
0000G0000000000000000T00000000
S000T00000G0000000000000000000
00000000000000S0S000000G00G000
000000000S000000T000000G000S00
0GS00S00000000000000000G0000H0
00S000000000000000000000000000
0000S000000000000000T000000000
0000G0T000G0000000000000000S00
00000GTS000000000G000000000000
GT000000000S0SC00000000000G000
T000000S000000000000000000S000
G0G000S000000000000S000000000C
00000000000000S0S0CG0000000000
00000000000000000GG0000000T000
000000000000000G0T0000000S0G00
