0000t000000000000000000000g000
00S00000000S00000g000000M000MM
00S0000t0000000000000000S00000
S00t0000000S000000000000M0M000
0000gt000000000000000000000000
t000g00S000000gB0000000BB00B00
0000S000g0000000t0000000000000
000t0000000000000S00000000000S
000000000000000000000000000000
g000g00t00000000S0B000B000S000
000gtS000000S0M0000g0000B00000
0t0000S000000S00000000g0000000
000000000t000000000000000S0000
00t00000000000000000000gS00000
000000000000000g00S0Sg0t00B000
t0000000000000S00gg0B000B00000
000000g000S000000g000000000t00
000g0S000000g00000000000000000
S0t0g0000g000000000S00000B0000
000t000000000000000000g0Sg0000
0000g000000g000000000000000000
00S000000000S000000t000000g000
g0000000000000g00S000000000000
000t000S0000000000000000000000
0Sg0000000g000000t00000000000S
0t0000000000000S0000S0000000M0
000000gt00000000gBS00000000000
00000000t000S00000S00g00000000
00000000000000S00000t00000S000
000t0000000000g00000g000000000
