00T000000000S0S000000000000000
0S0000000S000T0000000000000000
000ST00000G0000S00C00000000000
000000000G0000000000S000000000
T000000S00000S0000G0000000000G
00G00T000000000000000000000000
000000G00000000000000000000000
00000G00000G00000S0000000H0T00
000S0000000GT00000000G000H0000
000000000000000000000000000000
000T000000GS00000G0000000000H0
000000000000000T000G00000G000S
0000000000000SGG00H00000000T00
000T000000000000000G0G00000000
000000000000000000000000000G00
0000S000000000000G000000000000
000000G0S000G0H00000T000000000
0000000000000G00G0000000000000
0T000S0S00G00000000G0000000000
00STSC00000000000000000G000000
S000000000000000000000000S00T0
00000000000000000TS00000000000
000000T00000000000000000000000
0000000T000000000G000000000G00
0S0G00000000000000000000000000
0000000S0000000000000000T00GSC
0000000000T0000000000000000000
000T00G0GS000000000000000S0000
T00000000000000000000000000000
00000000S0T0000000000000000G00
