0000G00000000000000000T00S00S0
000G0000000000000T000000000000
00G00000T0000000000G00H0000000
0000000000T000000000S000S00000
0G00000000G000S00000000000000S
000000G000T000000S00S000000C00
G00000T00000000000S00000000000
S0G00000000S00G000T00000000H00
G0T00000G00000000000H0000S0000
00000000000000000000000000000G
0S0000000000000000S0C0000G0000
00000000000000000T000000000000
00000G0000000000T00S0000000000
0T0S0000000SC00000000GC0000000
0000S0S00G0T000000000000000000
S00000S000000000000000C0000T0G
0000000000T00000000000000S0G00
00000000T000G00000000000000000
0S0000000GG0000T00000H00000000
0000G0000000000000000T00000G00
G000000T000000000G0000H0000000
S00T00000000000000G000G00H0000
0000000000000000000G0000000000
00000000000000000S00000000G000
0G000S00G0T0H0S0000H0000000000
0000000000000T0000000S00000000
00000000S0T000000000S00CG00000
G000000000S0G00000000T00H00000
00000000000TG0000000S000000000
000000000S0000000G000000000000
