00000000000000GT0000
000S0000000T00000000
000GG000S0TS000000C0
00S00000S00C0000G00T
00000GS000000S0000T0
00000000TGG0000S00S0
00000T000SG0S0000000
0T00G000000000000000
00000000000S00000000
00000G000000T0000000
000G0000000000S00000
00000T000G000000S000
0SGS00C000G000T00000
000000T00000000G0000
T00G0000G00000000000
T000000000000000000G
000ST000000S00000G00
00T0000000S000000000
S0SC0T00000000G00000
000G00S000000000G000
