00G00T0000000G00000H0000000000
000000G000T00000S00000000G0000
00000000000T0000000S0000000000
0GT00000000000000S0G0000000000
00000000G00000000T0000S00SG000
000000000T0S0G000000000S000000
00000000000000S00G00000G000000
0000000000000000S0000000000000
0000T00000000000G000S00GS00000
0000S0000000000000000G00G0000H
00000G0T000000S00G000000000000
00000T0000S000000G000000000S00
0000000000G000000S000000000000
000T0000000G00000G000000000000
0000000000000000T0000000000000
G000000G0000000T000000000000H0
SS00000000C0T00C0000G000000G00
000000S0000000000000000000G000
000000G0S0000T000000000SG00C00
00G000000T0000000000S000000000
0T000000000SS00000000000000CC0
0SS00000C000G00C0G000000CHH0T0
0S0000G00000000000000000000000
00000T000000000000S00000000000
0G00S000G000H0000S000H0H000000
00T00000S00000G000S000000CC00G
0000000S000000000000T00G000000
00GG00000000S000000S0000000000
00G0000000G00000000TS00H000000
0000000T000000S0000G0000000000
