00000000S000000000G0
0T00S0GG000000000000
000000SS000T00000000
0000000T00000000G000
00S0000000T0000S0000
S0T00S00000G00000000
000G000000000000000T
00000S000S00000000T0
000G00000S000T000000
000000G000000000T0G0
00S00000S000G0000000
0G00G000000ST0000000
00000T00S00000000000
0000000000GT00000S0G
GG00S00000000S000T00
000T0000000000G000S0
00TG0000000000000000
0T000S00G00000000S0G
000T00000S0000000000
GT000000000000S0G000
