000000S000000T000000
T00000000000S0S0000C
T000000S00000G000000
0T00G0000G0S00000000
00000G0ST0000000000G
00T0000000S00G00G000
000000ST00S00C000000
S00000S000C0T00000G0
000G0000000000000000
S00000000000TS0G0000
G0G000S00000000000T0
T00G0000000000000000
00000T00GG0000000000
00GG0000000S000000S0
0T000000G00000000G00
0T0000000000G0000G00
0G0G00000000000000S0
00000000000000000000
T0000000000000000000
000000000000T00G0000
