000000t000000000000000g0000000
000000000000gt0000000S00000000
000000000t0000000000S000000000
g0000S0St0g00B0000000000000B00
g0000000000t000000gS0000000000
00000000000000S000000000000000
000000000000000S00S0000t000000
00g0000000000000000g000000000t
t000g000000g000000000000000000
S000S00000000000000000000t0000
0000000S0000000000000000000000
00000g000000000g000t0000000000
0000g00000000S000S000000000000
000000S00000000St00g00000gB000
t000g00000000g00000000S0000B00
0t0000000000000000000000S0000g
00000000000S000000g0000g000000
00000000000S000g0000000000t000
00000000000000000000000000St00
00000t0000000000S0000000000000
0000000000000000000000g000t000
00g00g00000tB00000000000000000
00000g00t0S0000000000000000000
0g000t00000000S0000S0M000g0000
0g00000S00t0000000000000000000
gg0000t00000B00000B00000000000
0g000S0g00000t00S0000000000000
000St0000000000000S0000g00g00M
00000000000S000000S000000g0000
00000000000g0000000000000000S0
