0000T0000G000000000000000S0S00
0000S0000000G00000T00000000000
G0S0S00000000C0000000000000000
000T00000000000000000000G00000
00000000S00000000G000T00000S00
00SG000000000G0000H0000000H000
0000000G000T000000S0G000000000
000000000G0000G0000000H0000000
00000000G000000T000G00000H0000
00000000G0000000000S0000000000
00G00000000000000SS0G000000000
0T0G000G0000000000000000000S00
000000000000000000000S000S00C0
0TS00000000000S000G00000000000
00000T000000000000000000000000
0000000G0S00SC00000T00000C0000
000T0000S000000000000000000000
000S00000ST0000GCC000000000000
00000000000000000T00GG00S00000
000S0G00000000000000S000000000
0000G000000000S0000GT0000000S0
T000000S0000000G00000000S00G00
00G00000000T00G000S000000000H0
0000000000S0000000000000000000
000T0000000000000000000G000000
000G0000T000000000G00000S0000S
000000000000G000G0000000000000
00000000000000T0G00000G0000000
00000S000000000000000S000000T0
000000000000S000000000000S0000
