0000000000000t0g00000000000000
0000000000000000S0000000000Sg0
000t00S0000000g00S0M00000M0000
00000S00000t000000g00000000000
0000t0000000S0000000g000000000
00000000000S00t00000000000S000
0t0000g00000000000000000g00000
000t0S00S00000g000000000000000
0g0000000000000000g0000B000000
0000000000S00g0tg0000000000000
g000000000000000S00S00000g0000
0000g000t000000g00000000000000
000000000St0000S0M000000000000
0000S000000000000S00M00M000000
g0g000000000000000000000000000
00t0g0000000000000000000000g00
0000000g0g00000000000000000000
0S0000000000t00000000000000000
00000S000000000000000000000000
0000g00000000g000B000000000000
0000000000000000S0000000t0000S
0000000000S000t00000g000000000
00000g000g00S000000000000B0000
00g000000000t00000000000000000
0g0S000000S00M00M00g0000000000
00000S0S000M00000g000000000000
000000000S0g000000t0000g000000
0000000000000000g0000000000000
00000000S00000g00g0000S00B0000
0000000000000t0000000000S0Sg00
