S000S0000000000M0000000000M000
0000000S0S00t000000000000M0000
0000000t0000000000g0S000000000
0000S0000000000000t00000g0000S
0000g0000000S00000000000S00000
0t0000000000000000S00000000000
000g000000000000000000t000g000
00000000000000g000000g0000S000
0000S00000St0g000000000g000B0B
00t000000000g00000000000000000
0000000000t0000000000000000000
0000000000000000tS000000000000
0000t0000000S0000000000000000S
g0000000000000t000000000000000
00g0000t00000000000000000000g0
00000000g000S00g00S00000t0000B
0t00000000000000000000S0000g00
0S00S000000000000g00t0g0000000
00000000t00000000000g0000g0000
00S00000S00000g0000000t0000000
00S0S0000000g00000000tM0000000
000000000000000t00000000000000
0000t00000000000000000000000S0
00000000000000000S0g0000000000
000t0g00000000000000000000S000
0000000gg000S00000000000000000
g000g00000000000000000000000t0
0000S0000000t000S000M000000gg0
00S0g00000g0000t00000000000000
00t000000000S0000g000000000000
