S0S00000G00000000000
000T000000S000000000
00T00000000G00000000
ST0000G0000000S00G00
G0S00000000G00000000
00000T00G00S00000000
000G000000000TS00000
0000000000S000000000
0T00000S00000000S000
0T00000SS00000000000
000S00GS0000T0000000
0000000000T0000S0000
0000S000SG0000000000
000000T0S00000G00S00
GT000000000000000000
000T0S000G000000SG00
00000000SG000T000G00
00000GTSS0G000000000
000SS000000000000G0G
000T000G00000G0S0000
