00GT0S00G00000000000
0G000G0000T000000000
00T0S00S000000000000
00G000000T00G0000000
00000000000000000000
00000000000000T00000
00000000G0000S00TG00
00000S00000000T0S0G0
STG00000S000000000G0
00000T0S000000000000
000G0000000000000000
00GT0000S0000000S000
000T000000000000000G
00SG00G0000000000000
00S0G000T000S0000000
0000000000000000G000
T0G00S00000G0000S000
00000000T000000S0000
00S0G0S0T00000000000
0000G0T000000000000S
