00000t0000000000S0000000000000
0000gS00000g0000000SM00M00M000
0S00SMg00000000000000t00000000
000000000000000000000000000000
00000000000000000t00g000000000
0000000t0000S00000000000000000
0000t0000000000000000000000000
00t00000000S000000000000000000
000S00t000g000000000000000000S
00000S0000g0S00000g00000000000
0000000t000000000000000S000000
000000000S000g00000tS00000g000
00g000000000t000000g000B000000
S00000000000S0000000g0000t0000
0000t000000S00000000000S00000g
000000000000t00000000000000000
000g00000000000000000000t00000
00000000000000000S0000g00000Sg
0000000St0000g00000000000g000S
000000gS0000g0000000000S000000
0t00S000000000S00M000000000000
0g000000S000000S00000t000M0000
000t00000000000000000g00000000
0000g0000S0000000000S0t0000000
S00000t0000000000000000S000000
00g0S00000000t0000000000000000
0000S00000000000000000000t0000
000000000000000000000t000S0000
0Sgt00000S00000000000000000000
000000000000000SSg0g0000B000M0
