0000000g000000g0000t0000000000
00g0000t000000000g00000000S0S0
0000000000000g000000t000000000
0S0tSMg000000000000g00000000B0
t0g0000000000g00000B0000000000
0gSt00000000000000g0B00000000S
00000000000t0000S0000000000000
00000t0S0g0g000000000000000000
000000000t0g000000000000000000
000000g000000S00000000000000g0
000t00000S00000g00g0S000B00000
000000t0000000000g000000000000
t0000000000gSS0000000000000000
0g0g0000000000000000000000SB00
g0000S00000000g00000B000000000
SS00g00t00000000000000M0000000
000000S00000000t00000000S00000
0000g00000000St0000g0000000000
000000000000g00000S0g000B00000
000t0000g00000S000000000000000
00000000000t00000000g000000000
00S0000S00000000000t0000000g00
gSt00000S000000M0000g000000B00
00000000000S0S00000000g000Mg00
t00000g00000000g00000000000000
00gg0000S00000000000B000t00B00
0000000000000t000000000000S000
00S00St00000000000000000000000
00000Sg0000000t0S0000000000000
000g000g00t000SS00000000000000
