0SSG0000G0000000000C00T0000000
00T00000S0000000000000000000S0
00000000000000S000000G00000000
GG000000H00000S000000ST0000000
00000000000000000000000000ST00
00000000000000000GG0S00000000T
0S0000000G0000T000000000S00000
0000000G0000000S00000000000ST0
G0GT00000HH000000S00H000S00000
0000T000000000G000000000000000
00000G000000T000000000000000G0
00S0000000000S000000G0TC000000
0G00000000000000T0000000000000
S00000000000000T0SCC0000000000
00S00000SG000T0G00000000000000
000000000000T000000000000S0G00
0000000000000T0000000000000000
G00000000G0000000000S00000000S
00000T0SSC0000000C000C00000000
000000000000000T00000000000000
0000000000T00000G0000000000000
T000000000G000000000G000000000
0000000000000S000000T00000S0G0
00000000G0S00000S0000000000000
00000000G000000T0000S000000000
00000S00000SG00000000000000000
0000000S00G0000G0000S000000000
00000000000S0000000000T00000G0
000S0000000000S000000G00000C00
TS000000000000000000S000000000
