0000t0000000g000g00000000000B0
00t000000g0g00000000000000B000
000g0000000000SS00000000000000
000g000S00000000g0000t00000000
0t000000000000000000000000S000
000000000000S0000000000000000S
0t00000000000000000000S0000g00
000000000t000000000000000000S0
000000S0000000000g0000g0000000
0000g00g0000000000B0000t000000
0t000000000g000000000000000000
0000000t000S000000000000g00000
000t000000000000000S000000000g
00000000t000g000000000000g0000
t0000000000000000S00000g0S0000
000000gg00000B000t000000S0B00S
0000t00g000000000000S000000000
0t000000g0000000000000000g0000
S000000000000000t0000000000000
00S000g0000t0000000000S0000000
t00000S000000000000S00000000gg
00g000000000000000000000000000
00t0000S000000000g000000S00000
S00000000000g00g0000B000000000
0000S00000000000000S000g000000
000t00000000000000000000000000
00000gS0g00B00Bt00000000000000
000S0g0g00B0000B0000000000S000
0t000000000S00g000000000000000
00000g000000000S000000t000000S
