S0000t000000000000000000000000
000000g00000g000000t0000S00B00
0S00t0000000000000000000000000
000t00000000000000000000000000
000000t000S00000S0000g000000M0
00000000t0000000000000S0000000
00S0000g000000000000000000000S
000000000000000S000g0000000000
0S0t00000g00S000000000g0000000
00000000000t00000000000S000000
00t000000S0000000000000000000g
000000000000S000g000000t0g0000
0g00g0000000B000B0S00B00B0000B
00S0g0000000000000000S0000000t
0S0000000t0000000S000000000000
0g0g00000B0B000S000000000B0000
t0g00000g0B000000S00B000B00000
00S00000000000000000t0000000g0
0g000000000000000t00000g000000
000000000Sg0000000g0SM00000000
000g00000000000000000g0S000000
00000g00000000000000000000t000
00Sg00000000S0000000000g000M0t
t000000000S0000000000g0000g000
000000S00000S00000000000000000
0000000000g000tS00000000g00000
00000000000000g000000000000000
000g0000000g0S000SMB000000000M
00tg00000000g000SB0000S0000000
00000g000tg0000000000000000000
