00000S0000000000000000000S0000
00G0000000000000T0000000G00000
0000000000000S000000T000000000
G0T000000000000S000000000000S0
S0000000000000000T000000000000
000000000S000G00000000T0S00000
000000000S000000TG0SC000000000
S00000000000000S00000000000000
00T00S000000000000000000000000
000G00000000000000000000G0H000
0000000T0G000000000S000000G000
00000000SS0000000C000000000000
00T0S0000000000000G00000000000
00S000000T0000000000000S000000
000000G0000000G0H0000000000000
000000000000S00TG000S00G00H000
000000000000000000000000000000
000000GGS00000H00000000000000S
00000T00000000000000000000000S
00S00000G0000S000G000000C00000
GTGH0000000000000000S000000000
00000000T0000S0G0000000000G000
000000000000000000S0000000G000
00000T000S00000000000000000S00
T0000000S0000000000000000G0000
0000G0000000G000000000000H0000
000000S00000000T0000S000000000
000000000S0000000000T0000G0G00
0000000000000000G00000000TG000
000000G0T0000000000000G0000000
