0T0000000000000000000000000000
0000G0000G00S000000000000000H0
00000S00000000000G0000000G000T
0000000000000TGS0GS0000000000H
00TG000000000G000H000000000000
000S00000000000000000000000000
T000G00G0000000000000S00000000
0000000000000S0000000T0000S000
00000G000000000000000000S00000
0000000000S0S00C000000T0000000
S000000G0000000000S000000T0000
000GS000000G00T0H000S000000000
00000000000000T00000G000000000
00000000G000000000000000S00000
T000S00000000G0000000000000G00
00G0000000000000000000S0000000
GGT0000000000000000000S00000S0
T000000G0000G00000000000000000
00T00G000000000000000000000000
000000000000000000S0000T0000S0
G000T00000000000GH000000000000
00000000000000000000S000000000
000000S0000G0G0000S00000000000
0T0S0S000000000000G00000000000
0S000G000T0000000S000000000000
00000G0000000000000000S0000SC0
000000G00T00000S00000G0S0C0000
0G000000000000000S00000GS0H000
T000000000000000000G000000000S
G000000000000000000000000000T0
