00S000000TG000000000000000S000
0000GGS00000H00000T000000S0000
000000000000000000000000000G00
000T000000S0000000S000000000C0
000000SS0000C00000GG0000000000
00000T00G00000S0G0000000S0000C
00T0S000000SC00000000000000000
00000000T00000S000000000000000
00S0000000000000000000000000T0
0000000000G00000T0000S00000000
00T00000000000S00000000000000S
000000000T00000000000000000000
00000T00000000GS0G000000000000
00000G0000000000TG0000000H0000
0G00T00000000000000S00000000G0
0000G000G000000000S0T000000S00
000000000G0000000000000T0G0000
000GG00S0T000000000S000H00C000
00000000000000T000000000000000
0000000000000000000000000G0000
000T00000000000G00000000000G00
000S000T0000G0000000G0H0000000
00G00T00G000000000S00000000000
G00000000000000S00000000000000
00000000GS000000000000000G0000
0SG0S0000000000000000C000000T0
00000T0000000G00G000000000H000
0000T000000000G0000000SG000S00
000000000S00G00000000G0000000S
00S0000000T0S0000000000000000C
