g0000St000000000S00000000000M0
00000000g000000000000000000000
0t00g000000000S0000000000000g0
S0000000000000000t0000000g0000
00000000t000000000S00000000000
000000000000000t000000000S0000
00000000S0S0000000000000g00000
S00000000000000000000000000000
000000000000g00000000000000000
00000000gS00000000SMM000000M00
0t0S00000S00g000000000M000000g
0000000g0000000000000000000Stg
000S00000S0g0000Mt00M0000000g0
000t0S00S000000000000000M00000
00S00S00000t00000000g0000g0000
tg000000g0000000000B000B000000
g000000000g000000000000SSB0000
S00000000000000000gS0000000000
S00S00gg0B000t0000000000000000
0g00S00000S00000000000M0000000
0000gS00g0Bt000000000S00000000
000000000000000g0g000000000000
000t0000S0000000000g0000000000
t00000000000000000000S00000000
0000000000000000000000g0000S00
0000000000S0000000g0000000S000
00000000g000000000000000000000
0g0000gBt0000BB0000S0000000000
000000000000SgS00000000g000000
000tS0000S00000M0000g0M0000000
