0000000t000S00000000g000g00000
000000000000000000t000000S00S0
00000000t000000g00g000000000B0
0t000000S000000000000000000000
0000000000000000000000000t0000
g0000000tS00000000S00000000g00
000000t00000000000000Sg0g00000
00000000S00000S00000g000000000
00000000000000000000g0000gBSS0
00000000t000000S00000000000000
0000000000000g000000000000SS00
0000gt0000000000000g0000000000
000S000000g000000000t000000000
00S0000S0000000t00000000000000
0000S0000000t00Sg0000000000000
0g0t000S0000000000000000000000
00000000000000t0Sg0000000g00B0
000000S00g000000t0000000000g00
t000g00000000000000g0000SS0000
00000g0000000000000SS000g000B0
0000g0g00000000000000000000000
t000000000000S00000000000g0000
0S000000g00000000000g00t000000
0S00000g00000000000000000g0S00
0g00000S000t000000000S00000000
g00t0000g0000000B0000S00000000
000000000g000S0S0000g00000B000
0000t0000S00000000000000000000
0000S00000000000gSg0t000000000
00S0g00S0000000M000t00000M000M
