00000000000000S00000000G0000ST
000T0000000SS00C00000000000000
00T0000000000000G0000000000GS0
000G000S0000GH000000H00S000000
T00000G00000000000000000000000
000000000000000000GG0000H00T00
000000000S00000000000000000000
00000000000000000000000000G00G
000000S000000T00G0000000000000
000S000000000000000G00000000G0
SG0000000000000000000TS0000G00
000000S0000000000000S000000000
0000000S0000000T00000000000000
0G00000000G000000000T000S0000S
T00000G000G00H0000000000000000
00000000000000T00G00000000000S
0T000S0000G0000000000000000000
000000000T000SG000000000000000
G0G0000000T0000000000000000000
00S0S0T00000000000000000000000
000T0G0S00S0000G000000000C0000
0000G000000T0000000000000G0000
000000000S0000000000T000000000
0000G0000S00000000T00000000S00
TS0S0C00000G000000000000000000
00000000G00GT000H0000000000000
00000000000000S00000T0000S0000
0000T0000000000000000000000000
S00000000000000TSC0000C0000C00
000000000000G0000000000G000T00
