0000S0t0000000S00000g000000000
00Sg00000000S00000000000000g00
000S00000g000g000000000t000000
g0000S00000000tg00000B00000B00
00000000000t000S00S00Mg000000g
0SgS000000000g000000B000000000
0000t00000000g0S00g0B000000000
g0000000000000000000t0000g0000
0SS0tM00000000000M000000000000
0000Sg00S0M00000000g0000000000
0000000S00g0000000000g0B000000
00g00000000000000000000t000000
0000000000000000S00000g00000g0
0t0000000000000000000000000S00
00g0S000g00B0S000t0000M0000000
00000000g000000g00000000000B00
00000000t0000000S000000000000g
000000000000000000000000000000
00g00S00000g0000000000Bt000000
0000g0000000000t0000000g0S0B0S
0000g000g000Bt00B0000000000000
SS0000000000000M0000000000t000
000000000000000000000000000000
0gt00000g0000000000000000SB000
000tgg00000000000B000000000000
g0000000S0g0B00000B00000000000
000gS000000000000000g00S000000
t000g0000000000000000000000000
t0g0000000000S0000000000000g00
000000000t000000S000000S0M0000
