S000000GS0T000000000000G0BM0M0
T0000000000000000000000S000000
00000S00000000G00000000S000000
00G000T00S00000000000S00000000
TS0000000000S0000000000M00000M
000000000000000000000T000G0000
000GG0000TS0000000000000B00000
0000000000000S00TS00000000000M
S0G000G00000T00000B000000B0000
00000000000T0000S0000000000000
000000G0S00000000000000S0T0000
T000000000000000G000000SS00000
0GGTS0000S0000000B0000000B000B
G0000S00S0G00B0000M00T0B000000
0000000000G00000000S00T0G00000
0S000000000T0000000G0000000000
00000GT0S00000000S0000000G0000
0G00000000S0S00000000G0000B000
G0S00000000000000G0000B0000000
000G00TS0SM00M00000GM000000000
000S00T0S0000000G0000000000000
000000G00T000000000000S00G000B
00000T0S00000000000S0000000M00
000000000S00000000TS0000000000
T0G0000000000000000000S00S0000
00000TS00000000000S00G00000000
000G000000G0T000000S00000S0M0B
0000T000000G000S000G000B000000
T00000000000S00000000000S00000
000000000T0000000000S000000000
