00000S00000000G0000S000G0000T0
000000000T00000000000000000000
000S0G00000S000M0M000000T00000
G00T000S00000000G0000000B00000
G000000000000S000000SM00M00000
0000000000000000T0GS0000000000
0000GT00000G0SB00B000000000000
000SG000000G0000000000000000B0
G000T00G00000000000S0000000000
00000ST0000SG00000000000M0G000
0000000S00000T000S00000M000000
S00000S0000000T0000000G0G00000
S000G0GS0MB0M0000000000000M0T0
00000T00000S00000000000000000G
S0S0000000000000T0M00000000000
0000000T00000S0000000000000000
00S000000000000000000S0000T000
00S0G00000T00000G0000000B00000
000000000000000G0S00SM00T0G000
00000000000000000000T000000000
000000000000000000000000000000
00000000000S00000000000000S0T0
000GT00000000000000000000S0000
00000G0S00000000000S0000000000
0000000000000000T0S00000000000
00000T0000GG000000000000000000
000000G0000000000000000T000G00
0GTS00000000000000000000000000
000000T0000S00000000G000000000
0GG0000SS0000000T00000000B0000
