0000t0000000000000000000000000
00000000g0000g000000000000tB00
000000000gg000000000S0000000B0
0g0000000000000000St0000000000
00g0000000000S000S000000t00000
0000gt00000000000000000S000000
S00t0000000000g0000S00000000g0
00t000000000000000000S00000g00
00t00000g0g0000000B00000S00000
00S000000000000gt0g0000S00000M
00000000000000t0000000g00000g0
0S00S000000000000000000000gM00
000000000t00000000000g00000000
S00g0t000000000000000000S00000
00000000g000t000g0000BS0000000
00000000S0S0000000000000M0M000
S0000000000000000000g0000000g0
0000000000000g0t00000000000S00
000S00000g0000Sg000t000000M000
00000000000g0t000g000000000000
0000000S000000000000000g000000
0S0000000000S000000MM000000000
0S000000000S000t0000000000000g
00000tg000000S0000000000000000
000000000000000000000000000000
0000000000000000000S00000S0000
0000g0000000t00S00000000000000
0g000000000000000t00g000000000
00tSS0000000000000g0000g00B000
g00000000000000000000g0S000000
