0000000000T000000000000000000S
T00000000000000000000000000000
00000000000T0S00000000000G00G0
TS00S00000C0000000000000000000
0000000000T0000000000000000000
0T000000000S0S00G000000000C000
000T0000G0000S0S0CG0H000000000
G0000000000000000T000000000000
0T0000000000000000GS0000000000
000000T0S0000000G000000S000000
00000000T00G00000G000000000000
000000T00000G000000000000SS000
T00000000000S00000000000G0000S
T00G00000GH0000S0000000000S000
00S00000000000000000T00000S00G
G000000SS00000000000T0000C00G0
000000SG000T00000000000S0CG000
S000G0000000TS0000000000C000G0
000000000G0000000000000000T000
000GGT000000000000000000000000
00000000000000000000000G000000
0000000000T0000000000000000000
00000000S0000000000G0000G00000
0G00000T0000S0000000000G00S000
00000T000G00000000000000G00000
0T0000S0000G0000G000S0C000000H
00S00000S0000000000000T000C000
00S0TG0000S000000000CG00000000
0S00000000000S0000T000C0000000
S0G0000000000G00H0000000T00000
