000000T0GS00000000S0000M000G00
000000000G000000S000G000000000
0T0000000000000000S00S00000G00
000000000000G0T00000G00B000000
0G000000S000S0MT00000000000000
T000000S0000000000000000000G00
0000G0000S00G00000B000S00000BB
000000GT00SG000000000S00MM0000
G00TS0000000000000000000000000
000000000000000000000000S0000T
0000000000000000000000T0G00000
000T00000G0000000000S000000G00
0000000000000000T00000000S0000
0000G0000GT0000000000000S000S0
000000S00000000S00000000000000
0G000G00000000000000000S000000
00000000000000G0000G0000000000
000G00000S0T0000000000000S0000
0S00000000S000G0000T0000000000
000000000ST00000000000000000GS
000000000000000000G000T00S00S0
00T00000G00000G000000000S00000
0000000000000000000000S00000T0
0000000000000GT000000000000000
0000000000T000000000000000000S
0000S000000G00S000000000T00GB0
T000S000G000G000000000S000000M
0000000000000T0000000000000000
T00G0000S0000000000G0B00000000
00000000000000000000S000000000
