S000000t0000000000S0000000M000
0g00000000000000000g00t000B000
0t000000000000000g000000000000
00SS000000MMg00000000000000g00
0S0g0S0000M0g000000000000B0000
00t0000000000000000gS0000Sg000
0000000000g000000S0g0tB0000000
0000000S00t000g0000000g00S000M
0000000S000000S000000g00g00000
0000000000000S0000000000000000
000000000S0000t00000g0g000SB0M
0000gt000g00000000B00000000000
00t00000000S000g0000000S00M000
00t000g00000000000000S00000g00
00S000S000g00t0MM0000000000M00
000000gS000000t000000000000000
00S000000000000gS00t000M000000
0000S000000000g000S0000000gM0t
00000000t0000000000S00000000S0
00S000000000000000t00000000000
0t00S000000000000g000000000S00
g0000000000000000000000000000t
00000St000000g0S000M0M00000000
g0000000g000000S0000S000000000
000000g00t00000000S0000000g000
0g00t000000S000000000000000000
g0000000000000000000000000t000
00t000000000000000000000000000
000000000000000000tS0000000000
00000000000t00000000000000g000
