0000000TG00000000000
S000S000000000T00000
00T0000G00000S000000
00000TG0G000000S0000
000000000000T000S000
000T000000G000000000
SST0000G00000000G000
S0000T00000000000G00
0G00000000SST0000000
00T00000000000000000
G00S000000000G0000S0
0S000000S0T000G0000G
0G0000G000T000000000
000S0S00G00000000000
0SS0T00000000G00G000
00T000S00000000000S0
G000T00S000000000S00
000S00000S000T000000
T00000G0000000000000
0000T0G00000S00G0000
