00TG00000000000000000S00000000
0G00S00G000000000000000T00000S
S0T00G0000000G00S0000000000000
00000S00000000000S000000000000
0T000000000G00SS0000000G000000
S00G0000000000000S00T00000G000
S000000T0000000000000000000000
0000T00G0000000000000000000000
000000S0S00T00G000000000000000
00000000000000G00T000000000G00
00000000000T000000000000000000
0G000000000T0000000000000000G0
0000000000000SS00GG0B000TM0000
00S00T0000000S00000GMM00000000
000000000000000000000000000000
G00000000TS0000000000000000000
00G00000T0S0000000000000000000
00T000S00000000000000000000000
00T00000G0000000000000G000000B
00000000T000000S00000000000G00
00G000000G0000000000000000S000
00000000000000000000000S0000S0
00S0000G0T00000000000000000000
00000S000000000000000000S00000
0000000T000000000G000000000000
000T0000S0000000G000000S000M00
0GT00000S000000000000000000000
000000000000S0000S0000G0000000
0000S00T0000000000000000000000
00S0000000T000000S0000000M0000
