0SG000000G00000000000T0000H000
000G0000000000GHT00000H0000S00
00000G0000000000000000000000T0
000000S00000S0G000000000TC0000
00000000000S0G0000000000000000
0000S0T0000S00C000000000000000
000000TGG0000000000000000000S0
S0000000000TS00C00G00C00000G00
00000T00000000G000000S000000G0
000000S000G00S0000000000000000
000G00000000G000T000000000HH00
000000S000G0000000000T0000000S
G000G000000000000000000S000000
G000000000000000SSG00000000000
0000000G0T000000000S0000000000
0000000000G000000S000000000GT0
00000000000S0G0G0000000S000000
0000000000S000000000S000000000
000T0S000000000000000000000000
0000G00000000000000000G00000S0
T00000SS00C0000000000000000000
00000000000000000T000000000000
T00G0000S000000000000000000000
S0T000000G0S000000000000G00000
000T000000000000000000000S0000
00000000000000G000TS0G0S000000
0S000TSG0000000000000000000000
0000T00G0000S00000G000H000S000
000000T0000000000000000G000000
00T0000000000000G000G000000000
