000000G0000TG000S00SB000000000
000000000000000000T000G000G000
0T000G0S000000000000000S000000
0000S00T0000000000000000S00000
00ST00000000000000000000000000
0G000000G000T0000000000000000S
00000T00S000000000000000G00000
0000G00000000000GSST0000000000
0T00000S0000000000000000000000
GS0000000G0T0000000000S0000000
S0000000000000000000000T000000
000000000GT0000000000000000000
000GS0S00000000000000000000M00
000000000G00000000000000000000
00000ST00000000000000000000000
G00000T00000G00000000000S0000S
0000000000S00S000000000T000000
T000G00000S0000G00000000000000
00GG000S0000000T00S00000000000
0000000T000000000G00000S000000
00S0000G000000000T000000000000
00000G00000000000S0G000B0T0000
00T00S000000000000000000000000
00000T0000000000000G0000G00000
00000000G0T00000000000000G0000
00000000000000000000000000000T
000000000000000000000000000000
000000000000T0000000000000G000
00000000G00G00S0000000S00000T0
S000000000000G0T0000000GB00000
