g00000g000S0000S000000000t0000
00S000t0000S000000000000000000
0000000000t0000000000000000000
00000000g000000000000000g00000
00000g00S0g0S000000000t0000000
0t000S00S000000M0000M0000000M0
0000g00000000S000000000000g000
S00000t00000000000000000000000
0000000000000S0tg0000S00000000
00000000000000tS00000000000000
000t0g00000S00000g00000000B0B0
t0000gg00000BB0000000000000000
000000000S00000t00000000000g00
0000000000000000t0g00000g00000
00000000000000t00S00000000S000
0000000t0000000000000000000000
S00S000MM00g000000M0g000000000
0000g0000g00000000000000S00000
0S00g00t00g0000000000000BS0000
000000000000000000000000000000
00g000000S0000000000000000S000
000gt0Sg0B0000B0000000000S000M
00000000St000g0000000000000000
t000000000000000000000g000g000
t00000000S0000000000000000g000
0000000000000000000000t0000000
00t000000S00000000000000000000
000000000000000t00S00000000000
0000S00g00000000000000t0000000
0000000S0g00g00000000000000000
