00000g000S00g0t000000000000000
0S00S00000000000M0000000M00000
t000000S000000000000g000g00000
000000000000000000000000000000
000000t00000000000000000000000
000S00g00000S00000000000000000
0000000g000g000B0000S0000000S0
S000000g0S000000g000000000B000
000gg000000t00000000000000S000
0t0g000000000000g0000S00000000
0t000000000000000000000000000S
00000000000g00g000000000000000
0S00t000000000000000S00000000g
g000g000000000000B00S0S0000000
0000000000000t0000000000000000
0000S0000000000S00000000000000
0000000000000000000g00000g0000
0t00Sg000000g0000S0000M0000000
000g00000S00000000000t00S00000
0000000S0000000000S00000000t00
t00000000000000S000000g00g0S00
00S0t000000000g0S0000000000000
000000000000t00g0000000000g000
0000t0000000000000000000000000
00S000000S000t000000g0000000g0
00000g000000000000000000000t00
00S00000000000t00S0M00M0M0M000
t000000000000000000000000000S0
S000000S00000000000000g000000M
S000000000000S0000000g00M00t00
