0G00TG0000H0000000000S00000000
000S00000000000000G0T000000000
000GT00000000000000G0000000000
0000TG00000000000000G0000000H0
0T0000000000000000S00000000000
000000000T0S000000000000000000
00000S00T000000000S00000000000
000000T00G0000G00000000S0000H0
000000000000000000000S00000000
S0G00000000G00000S000C0T000H0C
00000TS0S000000000G0000G000000
0000S000000T0000000S0000000000
G00000G0SH0S000000000H0000H000
000000000S000G0000000000000000
0000000000000G0000000000000000
0G000000TS000000000000S0000000
00000T0000000S0000000000000000
0000G0S000000S00000T0000000C00
0G0G000000000000SS000000T00000
0G0T000S000G000SC0000000000000
0S0000000GT00S0GH0000000000000
00S0S00CG0000000000000000000C0
G00000000G0000000000000H00T000
0000000000G00000000T0000G00000
00000000G00000000T000000000000
00T0000000000000000000000G0000
00S0G000000T000S0000G00CH0000H
G00000000000000000000T000000S0
000000T0000000G000000000000000
000000T0S000000000000000000000
