00g00000000000000t000000g00000
000g000000t000000000000S0g0000
000000S0000S0000000000000tM00M
0000g000000g00B000B0t000000000
0000000000000000g0000000000000
0000000t0000g0000000000S00g000
00g00000000000000tg00000000000
000000000tS0000000gS0000g000M0
000000000000S0000000000Sg00000
00S0000S00000000M0000000000000
000000000000t0S0000000000g0000
000000000000000Sg000000S000000
g000000000t00000000g0B00B00000
000S00000S000g00M00M0000gMM000
00000S00gg00B00000000000BS0Bt0
0g00S00t00000000000000S000g0MM
00S0000g00t0g00000000000000000
S0000g0000000000t00000000000g0
000000S0t000g0000000000g0B000S
00000000gS000000000S0000000000
0g00g0000000S00000000000000000
00000000g00000000g00B000000000
000000000000000t00000000000000
000000000g00000g000000S0000000
000g0000000S000t00000000000000
0g000S0000000t00000000000g0000
000000000S0S0gt00000000000M000
0000t000000000000000000g000000
0t0000000000000000000000000000
0g000t000000000000000S00000000
