000000000000000000000000000000
000000S00SC0000000000000000000
0000000000SG000000T00000000000
000000000000000000000000000000
0G00000000T00000S0000000G00000
00G0000S0000T00000000000000000
0S0000000000G0000T000000000G00
0000000000000S0S00000G00G00000
000000S000000000S0000T00G00G00
00TGS0000G00000000000000000000
00000000000G000000000000T00000
0000T00000S0000000000000G00000
0SSG000C000000G000000000000H00
G0GT00000000000000000SS0000000
00000G0000000000000000000S0000
0000G000000T000000000000000S00
000G000S00G0000000000S0000CH00
0000000000G00T000000000G000000
0T000000SG0000000000000S000G00
000000S000000T0000000000000000
0000000T00000000000S0000000000
00000S0000000SC000000000000000
0G000T00G0000000SS00C0000000H0
00TG0000S00S0GH00000C000000000
00000000000T00000G00G000000000
000S000000000000T000000000G000
S000000000S00C0G00000000000000
GS0000000T00G0000000H000000000
0000000000000000G000G000000000
0000000000000T00000000000G0000
