0G00T0S00000S000G00000000C0H00
0GS00000000000000T000000000000
000ST000000S000000000000000C00
T000000000000000000000000G0000
0000T0S000000000S00000000C0000
0G0T00000S0G000000SH0000000000
000TS0000000000000000000000000
S00000000S000C0000000000000000
00G0000000S000000G000000000000
00S0000000000000000000000000G0
0S0000000G00000T00S0CG00000000
000000S0000S000000000000000G0G
00TG0000GS0H000S00000000000000
G000T0G00000000000000000000000
00000000000000000G000TSS0C0000
00000000000000G0T0000000S00000
S000000000G000S0000000CG000000
000000000000000000000000000000
000ST0S00C0000000000G000000000
0000000000S00S000C000000000T00
000G000000000000T000000S0G0000
00T000000000S0000000000G000S00
00000T00000000000G000G0S000000
00G00000000000000000G000000000
0T0000000000000000G00GH0000S00
T0G0000000G0000000S0000H000S00
00000000SG0000000000TG00000000
0000G0000000000G00000S0TS00C00
00000T000000000000000S00000000
0G0T00000000G0HS0S000000000000
