000G0000S00000S000000000000000
0000000G0T00000000000S00000000
0000000000000T0S00000000000000
0000000GG000T0000H00000H000000
T00000000S000000G0000S00G00000
0G0G0000S000S0000C000000000T00
0000000000S00T0G0G00000S00000C
0000T000000000G000000000G00000
000000T000000000000000GS000000
000T0S00G0000S00GC000000000000
0G0G0H0HT000H00000000S00000000
0000000000G0000S00000000000000
S000000000S0T0C0000G0C00000000
G000000000000S000000000T000000
000T0000000000000000000000S000
0000000000000000000T0S00000000
0000S0000000T00000000000000000
0000S000G000000000S0T000G00000
000000000S0000000000000000000S
00S0000000000000S0C00C000000G0
0000G00000000S0000000000000S00
000000S00T00000000000000000000
0S00000000000T000000000000S000
0000000000000000S000000G000GH0
00000G0000T00000S00G0000000000
T000000000000S0SC0000000000000
S0000G00000000G0ST0000CH000000
GT00S0G00000000000000000000000
00000T000000000000SG0000S00000
S0000000G0GT0H0000000000000000
