TG000000000000S000000SM0000000
0000T00000S0000G00000000000000
000000GG0000000000000S00000T00
000000T0S0000000000000S000G000
0000S000000000GT00000G00000000
000000000000000000000000000S00
0G000000000G0B00000B0000000000
000G0000G0B0000T0000000000BS00
00T000000000000000000000000000
000G0000000S000T00000000000000
0000TS000000000000G00000000000
0000000000SG0000000S0000TG00B0
G00000G000000000000000000000T0
0000000T0000000000000GS00S0000
0000000TG000000000000000G00000
000000000000GT000000000000000G
000000S0T0000000GS0G00M00B0000
0G000000000000G0000T00000BB000
GT00S00000000G0000000000000000
000000000T00000G00000000000S00
00GS000000000000GT000000000000
0T0000000000000000000000000000
00000000000000T000000000000000
0000000S00000T0000000000000000
0000000000000000000000T0000000
00000G0T0000S000G00000S0B00000
000000S00000000G0000000000000S
000T00000000000000SS000G000000
G000000000GT0000000000000SB000
T00000000000000000S0000G000000
