0000000S00T000S000000M0000000G
T000000000000000S00000000S0G00
000000G0S000000000000000000000
00G0000000000T0G000000000S0000
000S00000S00M00000GMM000000000
00000000000000000000T000000000
T0G0000000G0000000000B0S000B00
00T00000000G000000000000S00000
000000000000000G0G0000000S0000
00000000000G00000000G000000000
000000000000000SS0000000000000
000000000000S0G000000000000000
000000000000000T00000000S00000
T000000000000G0000000000000000
T000S0000000S00000000000000MG0
00T00000S00G000000000000G000S0
00000G000000T00000000000000000
00G0000000S00000G00S0000000000
G0000000G00T000000000000000000
0GS00000000000000000000000T000
000000000T00SGG0000000000000B0
00G000000000000G00T000S0000000
0000T00000SG000000000000000000
0000T0S000S0000000G00000000000
0S000G000GT00S0M0000M000000000
00000000TS00000000000S0G000000
00000S0000G000G000000000000000
00000S000S000G000T00M00G000000
0000S000000000T00000000G000000
000000G0S000000G00S0B000B00000
