000000T000G000S0S00G0000000000
000000S000000000000000S0000000
00T0S00000000000000S00G0000000
00G0000000000000S0000000000000
000T00000S00000000000000G00G00
0000000000000000000000000S000S
00S000GG0000T0H0SC000000000000
0G0T00000000000000000000000000
0G0000000000000000000000000000
G000ST00000G0000S000000000C000
000TSG000000000000000000000000
0T0S000000G000S000000000000000
00T00000000000000S0000000G0000
000G0000000000G0000000T00000H0
000T00000000S0000S00000000CG0G
0000S0T0000000000000000G000000
000000G0000S000000000000G00000
00000000000GT00G0H000S00000000
0T00000000S000000G000000000000
000000000T000000000000000000S0
000000S00000G0G0T0000000000000
000S00S00G00C00000000000000G00
0G0S0T000S00000GH00000000C0000
00000000T00000000000000000G0S0
0G0000000000000000000000G00000
000T00000000000000000G00000000
00000000000000G000000GT0H00000
000000000000000G000S0000000000
000000T000000000G0000000000000
000GS000000000000T000000G000S0
