S00t00000gS000000000M00M0M00M0
000000000t000000S0S00g00000000
00000t00SS0000000000000M000g00
0S0S00000M00M000000g00000t0000
g00000000t000000SS000000000000
000000000000000000S00000t00000
00000000000t0000SS000000000000
0S0t00S000000000g0000g00M0M000
00000000gS00000000g0B00000tS0M
000000S00S0000t0000gg000000000
St0S00000000000g000000000M0000
S00000000S00g0000000000000g000
000000000000000S0000g00g000000
0000000t0000000000000000000000
00000000000000t00000000S000000
00t000000gS00000g00000B0B00000
00t0000000000S0000000000000000
00g00000000000gt000000S00B000S
t000000000000000g000000000000S
000000g000000000000t000000S000
00S00000000000t000000000000000
00000S00g000000000000t00000000
000000000000000000000000000000
00000S000000t0000000g000000000
0t00S0000S000000000000g0000000
0t00000000000S0000000000000g00
S000000000000S0000000M00000t00
00000000Sg000000000000000t00g0
0000000t00000g0g000000000000B0
0000g000t000000000000000000000
