0000000000000TS00000
G000G0S00T0000000000
000GS00GS000000T0000
000T0000000S00000000
00000ST00S0000000000
0TG00G00000000000000
0000000000000T00GG00
00G000S0000000G00000
0000T00G00000S00S000
000000000000S0G00000
000000T0G00000G00000
00000000000S0T000G00
00S0T00000G0000G0000
0000S000G000000T0000
000ST0S00000G00G0000
00000S0S000T0G000000
00G00000G000T0000000
000G0T00000000000000
0000ST0000000S0G0000
0000T00000000000S000
