000000GT00000G0000S00000000000
0T0000000000000000000S0000G000
00SG00SM0000GB000000MB00000000
0T0000000SG0000000000000000000
00000S00T00000000S000000M00000
000000T00000000000000S00000000
000000G00000000000000000S0G000
0000T0S00000000000000G000S0000
G00000S00000G0000000000000B000
0000S00000000000T0000000000000
000000000000T00000000000000000
T00000S0000G000000000000000000
0000000000T000000000000GS00000
00000G0S000000000T0S0M00000000
000000000000000000000000G00000
0000000T0SG0000000000000000000
000000000000000G00S000GB0000S0
G00000000G000S0000000000000000
0000000000S0000000000000G00000
0000000S00000G0G0000000000B000
000000000000000T000000000S00G0
000000000000000000000000000000
0000000G0000T000000G00000S0000
T000000G0000000000G00000000000
0000000000T00S0000S0G000000000
S000000000S000000M000000000000
0000000000S00G000G00S0TB00B000
0000000000TS00000000S00000000G
00T000000000S00000S00000000000
00000000000000000T000000000000
