000t0000S00000000S00000M0g0000
S0000000000000t000000000000000
0Sg00000000g000t000000000000B0
000000g000000000000g0S000000B0
0g0t00000000S00000g00000000000
0g00000000g0000000000000000000
0000000S000S0000M000000000M000
000g00000S0S00000000000000M000
00g000000000000S00000000000000
0000g00000000t000000000000SS00
00000000SS00g0t000000000MM0000
000t0000000g0000000000g0000000
00000000000000000000000000000t
t000000g0000000000000g000S0000
0000000000000000000000g0000000
0000000tSS00g0000000M0gM000000
000000000000g0t000000000000000
0000000000S000g00t00g000000000
000000000t00000000000000g0S00g
00000000000000S00000000000St00
g00000000000t000000g000000000S
t000gS0S0000000000000g0000M000
00000000g00000S000000000000000
000000000000000S0t00000000S0g0
00000000000Sg0t0000000000g0000
t000000000000000000000000000S0
00000000000000000000gt000g0000
00t000000000000000000000S000g0
000t000000000000000000000000S0
000000000g00tS0000000000000000
