000000GG00000000T0S0
000000TG00000000000G
00GT000S000G00000000
0000S00T0000G0000000
G0S0T0SC000000000000
T0S0000000G0000G00S0
00G000T000000S00G000
00000T00G0S00S000000
0G000000G0S00T000S00
SS000C000T0000000000
000S0T00000000000G00
0G0000000S0000T00000
S0T0000000000S0000C0
00000T0S0000G000000S
0S0000000000000000S0
G0000S00000S0T000G00
000G000T000000000000
S0000000GG000T0000S0
0000000T0000000000G0
00000G00000G00000000
