0000S000S000000000C0
000GG000T00000000000
0S00000T0G000000000S
00T0S0000000S0000000
00000000ST0G00000000
0T0G00000S0000G00000
SS0000000000CT000000
000S00000000000T0000
000T00G0000000000000
000000G00S0S0C0G0000
000000000S0S00000000
00G00000000000000000
000S00T0000G00000000
00TG0G0000000S000000
000ST0000000000000G0
0000S00000G000G000T0
S0S000GT000000000000
0000000000000G0TGS00
T00000G000000000SS00
T000S00S00C000000000
