000S000T0000G0000000000G000000
00T000000G00000000000000000000
0T00000S0000000000G000000SG000
00000G00000000000000ST00000000
0000000G0T00000000000000000000
00G0000T00000000000000000S0000
0000000000000000S000T0S0000000
00000G0000000000000000S0000000
0000G00000000000000000000000T0
0TG00000000G000000H00S000S0000
0G00000000G00000S0000000000000
000T0000000000000G00S000000000
00S000G000000T0000000000000000
T00G000S0000000000S000C000000G
0G00G000000000000000S00H00H000
000000T00S00000S0000000000C000
000G000S0000G000000000SC000000
0000000000000000S0000000000000
00000T00G0000000000000000000G0
0000000000000000000000000000G0
00T000S00S00000000000000G00000
S000S00C0000C00000000000000000
0G000T00000G00000H000000000S00
00T00000000000S00G00G00H0H0000
00T000000000000000000000000000
000T00000S00000S0G00C00000C000
0000000000G000S00000S00C000000
T000000000000S000000000000S000
00S000000000000000000000000000
000000000000000000000000000000
