00000000000T00G000000GH000S000
S0000000T0000000000000000G0000
00000T000000000G000S0000000G00
000000000GG00000000000T000000S
00S0000000000000T0000000000000
0T000000000000000S000000000000
00000000000TS0000G000000000000
000SG000000GH00S00000000000000
000T0G000000000000000000000000
0000T0000000000000000G00000000
000000T000000S00000000G000G000
000T00000S00000000000G000000S0
0000000000T0000000000000000000
0000G000000S000000000000000000
00S0T0000000000000000000G00000
00G000000000000000000000000000
000000000000000000000000000000
00000000S0G000T000G0000H000000
T0000000000000000000000000000S
G0000000T000000000G000000S0000
0000000S000000G0000000000T0000
000000T00000000000000000000000
0000000000S0000S0000000T000000
0000000000000G00000T0000000000
0S0000T00000000000000000000000
0000000000G000000G000000000000
0000G000000000000000T000000000
00000000G0000000000000000T0000
0000T00G00000S0000000000000000
000T000000000000000S0000000G00
