00S00S00000T00000C000000000000
00000000000G000S0ST00000000000
T00S00S00G000C0000000000000000
000S00GS0000000000C00000G0000T
0T00000000000S0000G0G00000S000
000000S000000S000T000000000000
000ST000000000000G000S00000000
0G000T00000G00S000000000000000
000000T0GS00000000000000000000
00000000000000GG000000T0000000
000000000000000S00000G00000000
G0T0G000H000000000000000000000
000S00000G000000000000G00H0000
GT000000S000G000S0000000000C00
000T00000S00000000000000000000
0S0000000000000000T00000S00000
000000000T000GG000000000000000
0000T0G000000S0000000GS0H00C00
000000000000000000000000T0G000
0000S0GS0000000000000G00000000
0G000000000T0S00S0C00000000000
00000T000000000000000000000000
0GG000T0000S00H000000000000000
0000000S0T00G00S000C0000000000
T000000000G00000000S0000000G00
000000000000G000SS000000000000
000TS0000000000000G0000000G000
0000000SG000T00S00000000000000
T00000000000000000000000000G00
00000000T00000000000000S0G0000
