0t0000g0000000g000000000000000
000g0000g0000tB00000000S000000
00000g00000000g000B00t00S00000
000t00000000000000000000000000
S00000g00000000g0S000000000000
S00000000000t00000000000000000
00000000000000g0000000000g0000
000g000000000S0000000000000000
t00S0000S000000000000000000000
0000000g0g000S00000000000000t0
tg00000g0000S0000000000000S000
t00000S0000000000000g0g0S00000
0000000000000000000g0000000000
t00g0000S000000000000000000000
000000g00t00000000000000g00000
000000000000t00000000000000000
0gt0000000000000g000000000000S
000000000000000000000000000000
0000000t0000000000000g00000000
00S000000000t000000000000000Sg
00000000000000000000000S0000S0
000000000000S00000000000000000
S000g000S00M000000000000000000
t00S00000000000000000000000000
0000g0g00t00000BS00S0000000000
0000000000S00g0g00000B0000t000
00000000000gt00000000000000Sg0
0000000g0g00000000000t00000000
00000000g0t0000000000000000000
000000000000000g000g0000B00000
