0t00000000gg0000000000000BB00S
00000000000000t000000g00S00000
S0000000g000000g000000S0000000
00S000t0000000000000000g0S00Mg
00000g00000000000g00t00S000000
00000g00g0000000S0000000000000
000000000t0S0000000g0000000000
0000000S0000000gg00000B000t000
00000000000000000000000t000g00
00tS0000000000000g00000S0000M0
000S0t000g0000000g000000000000
00000000000S0000g0000000000000
0000g0000S000S000000t000000000
000g00S0g0000S00000000t0000000
00000000000000000000S00000g0S0
000S0000S000g000g000B000000000
0g0000000000000000000000S000g0
00000000000gg0t000000000B00000
00S00t00g00Sg0000B00000M00B00B
000t000000000000g0000S00g00S00
g000000000000S000000tg00000000
00000000000000000g000g000S0000
0000000S0000t00000000000000000
S000000t0g000Sg000000000000000
0S0g0g00000B0B000S000000000B00
00t000000000000g00000000000000
0000t0000000000000000000000000
000000g000t00g0000000000000000
000000000000S0t000000S00000000
0000000g0000000t00000000000000
