0T0000000G000000000000000S0000
0000000000000000G00S0000GT0000
00000G0000S0SM00T000000M0000G0
0000T000000000S0000000000S000M
00G000000T00000000000000000000
T000000S000S00000000000000G000
T0000G000G0B000000000000B00000
0STS0000000000000000M000000000
000000000G000T0000000S00000S00
0G0S0T000000000G00000S0000M000
0000G0T000000000000000000000S0
00000000000000000000T0000S0000
S000000GG000000B0000000T000000
000000000S0000T0000000S0000000
0000G0000S000G0000000000000000
0000000T000000000000000000000G
0G0G00000S0T0000000000000S0000
000GS00T0S0000000000M0G0000000
0000000000TG000000000000000000
000000T0000000000000000S000G00
00T00000S0S00000G0000000000000
000T00000000S00G0000G000000000
0000000T000S00G00000000000S000
00000000000000000G000000G0000B
000000S00000T00000000000000000
00G0S000S0T0000000000000000000
00S00T00000000000S000M00000000
0T00G00000S000000GS00000000000
0000T00000000000000000000000S0
00000T000000SG0000000000000000
