000000000g00000SS0000000g00000
00Sg000000S000tg00000000000000
0000t00000000S0ggS000000000000
00000000000000gS0000g0B0B00000
00000t000g0S000000000S0000000g
t00g0000000000g000000000000000
00000000000gt00000000000g0000S
0000g00000S00000000g0t00000S00
0t0SS000000000000M000000000000
000000S00g000000000t0000000SM0
00000000000000t000000000000000
00gt00000000000000000g00000000
0000000000000000000000g000000t
000000000000Sg000000S000M0000t
0000t00000S0000000000000g00000
00000000000000g0000000SSt00000
000000000000000t0000g000000000
0000000000S0000000000000000000
00S0000000000g000g0BB0000S0M00
0S00S0gM000g0000B00000B0000000
t00000000000g00000g000S0000000
00000000000000000Sgg0t000000S0
0000000000000gt0g000000000SB00
0000S00000S0000000000000000000
0000000000000S00000000t0S0g000
000000000000000g0000000000000g
St000S00000g0000000000000g0000
000000000000000000000g00000000
S00000000000000000000000000000
g00t00000000000g000000S00B0000
