000S000000S000000000000000t000
00000t000000000Sg000000S000000
00000St00000000000000000g00S00
0000000t000000S000g00000000000
0000000g0000S00gS0000000000000
00000000000000000000000t000000
000000g0000000000000g000000000
t00000000000000000000000000000
0000S0000t000000000000SM000000
0000000000t00S0000000S00000000
0000000000000gg0000S0000000000
0000g0000gSB000000000000000000
0000g0S00000000t00000000000SMM
0000000000000000000000000S0000
0g000000000SSg0t00000000000000
000000S00gg0000000000t0B000B0B
00000000S0gS000000000000000000
0000000t0000g00g00000000S00000
000000000g00000S0000St0g000000
gg000000000000000B000000000000
0000000t000000S000000000000000
00000000000000g000000000000g00
000g0SS00M0000000M0g000000000M
000000000000000000g0S0000000g0
00000000t000g0000000000000g000
0000t00000000000000000000000S0
00g00000g00B0000S00BS00000000M
000000t000000000000000ggB00000
0t000000000000000000Sg0Sg00000
0S00g000000000S0000M0000000g00
