S0S0G00G000000000T0CC00000000H
00000S0000000S000C000000C0T00C
S0G0000000ST00G0000H000000H000
T000G0000S0000G0000S0000000000
000000000S0S000000C0T00G0000C0
00G0G000000000000S0000S0000000
GT0000000000000000G0000000H000
0000000000000000000T0000000000
000TS000000000000000SC00000000
00T0000000G0G00000000000000H0H
0S0000000000000000000000000000
0000000G000T0000G0000000H00000
0000000S000S0000G00000C0000000
00000T00000000000G00000000000S
000000000000S00000000T00000000
0000000T0000S0G0SG000C00C0000C
0000000000S000000S0G0000000000
00000G000000000T0000000000000G
000000G0T0S0000000S000G0000000
00000G000G00000000H0S00T000000
000000S0G000000000G0000000000S
00000000000T00000000S000000000
0G000G000S00000000000000T00000
00000T00000000000000G000000000
000TS0S0C000000000000000G00000
T000000G000000S0G0000000000000
0000000000000S0000000ST0G00000
0SS0000C00C0000T00000000000000
0000000000000000T0000000000000
0000000000000000000000000S0000
