00000000000000G0T000000G000000
00000S000000000000G000G000B000
0T00000000G0000000000000000000
00000000000S00000000T000000000
00T0SG0000000000000000S0000G00
0G0000000000S00000000000000000
0000G00S0SG00M00MB000000000000
000000000S0G000000000000000000
000T000000000000000000000S00S0
00000000000G0T0000000S000000S0
0SS00000M000000000000M00000M00
00S0S0T000000000000M0000M0G000
00000000000S00000GS00000000G00
00S00000SG000000000GT000000000
00G0000000GT00000000000S0000S0
0000000TS000000000G0000000000S
0T0000S00000000G0000S000000000
0T00000S000S00M00000000000M000
00000000S00000T00000S000000000
0S000G0000G0000000000000S00M0T
GGB00B00000000B000000000000000
S0TG00000000000000000S00000G0B
00000000000000S0000000000000T0
00000G0000000000000000S0G00000
0000000SS0TG000000000000000G00
0000S00G00000000T0000000000000
0G00T000000000000000000000000G
000T00000000000G0000S000000000
000T00S00S00000G00000000000000
000S0T00000000S000000G00000000
