0T00000000000G0SS000000M000000
000000T00000000G000000G00000B0
000000000000000000000000G000GB
00000000T0GSG00S0000B0000000B0
000000T00G0SS0M00000000000MM00
G00000000S00000000000000000000
0SG000000000S0M0M00000000000G0
S00GG0000SM0000000000M00000000
0000000000T0000000000G0000000G
S0S00000M00000M000000T000000M0
0G000GB0000000000000S000000000
T000000G000S0S000G000000000000
0000000000000T0000000000000G00
000S00T0000000000000G0000000S0
0000000000S0000000SGT0M0000000
0G000000000000G0000000B0000000
00T000000000S0000000G00S000000
00T000000000S0000000S000GM0000
G0S000000000G0T000000000000B00
00G000000000000G000T000000SS00
000S00000G0T00SG000000000000M0
00000000T0000G000G000000000000
00000000S0000000000S0000000000
0000000000000000000GG000000000
00000000000S0S00000000000000M0
000T00S00000000000S00000M0M0MG
0G00000000000000000000000T0000
000G00000000000000000000000000
000000S00000G00000G0000000S000
00000000T000000000000S00000000
