00000000000tg000000000S0000000
0tS0000S0000000g000g0000MB00M0
S00t0S0000000000M0000000gM0000
S00g00000t00000S00000000000M00
S0t0000g0000000000000000000000
0000000t0000000g0000SgS0M0000M
000000S0000S00000000t0g00000g0
000000t000000000000g0000000000
0t000000g0000g00000000B0000S00
0g0000000000g0S000B000S000000B
0000t00000000000000000S0000000
00000000S0000000g00S0000000000
00000000000000g000000000000000
00t0000000gS0S000g00M000B00000
000g0g0S0000000000000000000000
0000t00g00S00000g000000000000S
0000000000gS0000000000t0000000
0t00g000000000g00000000000S000
000S000S00000000000000000g0g00
S0t0000000000000000000000S0000
000000g0000000000g000000000B00
00000g00000g0S00000t0000000000
00g00000g0000000000t0000000000
0S000S00000000M000000000000000
0000g000000000t000000000000S00
0t000000000000g0000S0000000000
00t00SgS0000000000000M00000000
000S000g0000000t00000000000S00
00000S0S00000000t00000g00M0000
00gg0000000B000000000t00000000
