000000000000000000000000000000
0000000000000000000S00T0000000
00000000000SG00000000000000T00
0000000000S00T00000G0S0000000G
0000000000000000000T000S000000
SS0000C0G00000000000000000T000
0SGG000000000S000H0000000000H0
00G0000000000S00S00000000T0000
00000000000000000000000G0SGS00
0T00G0000000000SS0C00000000000
00000000000000G000000000000000
00S00000TS00000G000000000C0000
0000000000000000000G00000000ST
00TS00000000000S0000000G000000
0000T000S0S0000G000C0000000G00
000000000000S00000S00000000G00
T0S00G00000000000G00000S00000H
SS00000000000000000000000T0000
T0G00000S00000000000000000G000
G00S0000S0000000000000000G0000
S0000S00G00T00000G000000000000
0000000000T000G0S00G0000H000H0
000G000GT0000S0000000000S00000
000G000000G000000000000TH0S00S
0000SS000000000000000000000000
00000000G0T000000000000000000G
0G0000000000G00000000000000000
00G00000G0000S00000000HH000000
000T000G00G00000000000H0000000
00000SSC00T0C0G00000000000000C
