000S00000000SG0000000000000000
0000000000000T0000000S000000S0
00000S00000000G000000G00000000
000G00000G00000000000000000000
0000000000T000000S000000000000
000000000000T000S0GG00S0B00000
0000000T0000000000000000000000
00000000000G0000GBB0S00B0T0000
0000000T0000000000000000000000
00000000000000000G0000000S0T00
0000G00000T0S00000000000000000
0000000000G0000000S000000S0000
00000000000000T000000000000000
00000G00000G000000S0000T000000
00000000000G0000G00B0BB0000000
000T000000000G00GS0S0B00000000
G0000000S000000000T000G0000000
000000000000000000000000000000
0G0000000000000000000000SG0000
0000000000000000S000G00000000G
0000T0000000000000000000S00000
GT000000000000000000000S000000
00000000000T0000S0000000000000
0000000000S0000000000000000000
0G0000000000000000000000000000
0T000000000000000000000S00G000
000000000000000S00T00000000000
S0S00000MT00G00M00000000000000
00G000S000000T0000SM0000000000
00000000000000G000T00G00000B00
