00000000G00000T000S000S000G000
0000S0000000000000000T00000000
00T0000000000000000000000000S0
000000G00000S000000G0000000000
0000S0000000000GT0000G00000000
00000000000000000S00S00T000000
0S000000000T0000000000000000S0
0000S00000T000000000000G000G0B
000000G00T000000SG000000000000
0000000000000000000T000S000000
SS0M0000T000000000000000000000
0000000G0GB00B0000BB000T000000
00S000T00000000S00GM0G00000000
000000000000000000000000000000
0S0G000000000S00000MT0000G0000
0000000000000T00G0S000S0000000
00000000T000S00G000S0000000000
000S00000000T00000000000000000
G000G0000000000B0000B00B000000
0G0000000000000000G00T0B00000S
T000000000G000G000B00000B00000
000000000GST00S0000G0000000000
0G00000G0T0000000000000000S000
0T0000000000000000000000000S00
00S0000T0000000000000000000000
000000000000S00S0G0G0000000000
000G00T0000000000S000000000000
0T00000000000S00000G0G00B000B0
00GS00S00M0G0T00M00000000000M0
000T000000000G0000000000000000
