000GG00000000000000000T0000000
0S000000000S000000000000C0T000
0S00TG0000000000S000000000G000
000000T00000S00G00000000000000
T000S00000S0000000000000000000
000000T0000000000000S000000000
0000T0000000000000000000SG0S0C
0S000000000G0TS00000C000000000
T0000000000000000G000000000000
00000S0000000000000000000S0000
0S0T00000000000000000G00000S00
0T000G0000000GH000000000000S00
000000000000000GTG000S00000000
0000T000000S0000000G0000000000
000S00G00S000G00000H0000000000
00000000000000000T000000000000
00000000000000000000S000S00000
000000000000000000000000000000
0000T000000000000000000000G0G0
00T00000S000S00000000000000000
00000G000ST00000000000G00000H0
00000000000000000000T000000000
0T00000S000SC00000000000000000
000000T00000000000S0G000000000
0000000000S000S00T000000000000
000000G000000000G0000000000000
00T00000000G000000000000000G0H
00000G0000000TS00000000S000000
G00000000000000000000000000000
0G00GTH0000000S00000S000000000
