0000000G0000000000000G0T000000
0S00000000S00000000T000000G000
000000S0G00S0000000G000HCC0TH0
0000000000000000G0000000000000
0TG000000000000000000000000000
G00000T000000S000000G000H00000
0000S0000T000G000000000G000000
00T0000000000S00000000G0000000
0SS0C0000T0000000G0000000G000H
0G000S000S000000000000C0000000
0000000000000000T000000G00S000
00GT000000000000000000000000GH
0000000000000000000T00S0000000
0000000000G0T00000000000S00000
00TS0000000G000000G0000S0000H0
000000000000000000T00000000000
0000000T0000000000S00000G00000
00000000000000000T000S000G0G00
0G000000000000000S00000S0G0000
0G00000G000H00000000000T0000S0
000G0000000S0000000000TG000H00
00G000000000000000G00T000000S0
0TGSS000C000000000000000000000
0S000000000000G0000000000TG000
000000T000S00000G0000000000G00
0G0000S0T0000000S00G00C0000000
S00G0000000T000000000000000000
0SS000G000000000G000T000000000
T0000G00000000000000000000G000
000T0000000S000S0C00G00C0G0000
