000000Sg0000000000000000000000
0000000000000t0000000000g0g000
tgS00000000000g000000000BS0000
000000000000S00000t0000S000000
0g00000000000000St000000000000
00t000000000000000000000000000
00000t000000000000000000000000
000000000g00000t0000S00000g000
g00S000000t00g0000B00000000000
0St0S0g00000000g0000BM00000000
0g000000t000000S0gB0S000000000
00000000000000S0000t0g00000000
0000g0000000000S000000t0000000
gS0000000g0000000B0000000S00t0
00000000000000000000g0000S0000
0000gS000000000000000000g000B0
0000000g00g0000S00000000t00000
0000000S000000000S0t0000000000
00t00000000000000000000S000000
t0000000000000000000000000g0g0
00t0000000000000000000000000g0
000000000000t00000000000000000
000000t00Sg000000000000000000S
00000000000000000000t00Sg00g00
S0000000000000S0000M000t000000
00000000000g0000000St00000g000
0t00000000000000000000000gS000
000000S000000000000000g0000g00
000000gt00S0000000000000000000
000000000t0000000SS00000000000
