00000000000G000G0S000000000000
00T00000S000G00000000000000000
0000T000000000000000S000S00000
000000T0000000G000000000000000
000G00000000G0H000000000000000
000T000000S0000G00000000000000
00000T000000S00000S0C0G0000000
00G00000G0000000000000000000S0
00G000000000000000000000000000
000S00000000T00000000G00000000
00000G0000000T00000G0000000000
0000000000000000000000000000T0
00000000T00000000000000G00000G
000000000000000000000000000000
00000T0S000000000000G000000000
00000000G000000000000T0000G000
0G0000000000000000000T00000000
00000000G000G000H0000000000000
000000000G0000T000000S00000000
00000GS000000000000G0000000000
000000000G0G0S000SH000C00000T0
000000000000000000000000000000
000000T0S0000000000S0000000000
000000T000SS000CG000G0000000H0
0S00GT00000000S00G000000000000
0000G0000S000000G0S0000000H0C0
G00000TGSS0000C0000H0000000000
0000000GS00000000000T000000000
0G00TS00S000G0000000000H000000
T00000000000000S000000000S0000
