S000S000T000000000000C00000000
000S00000000000T00000000000000
0S000G00000000000S000000000000
00000000S0G00000000000S000000T
000G0000000000000000S0SG00CH00
ST0000000000000S00000000000000
000000000T00000000000000000000
GG0H0000000000000000S00000000S
000000S00000S000G00000C00T0000
00000S0T0000000000SG0000000C00
00S0T00000000000S00000000GC000
00G0000T000000G0S000000H000000
00S0000GG00000000000000000S000
000G000000000000000000T0000000
000000000000000000000000000000
GS0S00000000G00000C0000H0000T0
T00000000000000000G00000000000
G00000000000000000000000000000
00G0SS0000000G0000000000H00000
00T0000S0S00000C00000G00000000
000000S0G00G000000S00000000000
ST0G00SGC000000000000000000000
0S000000000000000000000S000000
0S000000G0T0000000000000000000
000G0000000000000T00SG00000000
000000000000000000000000000000
0T000000000G0000S0G00000000000
0G0000S000TG000000000H00000000
0S0000T000S00G00G0000000000000
T000G0000000000000S00000000000
