0000G0GS000000000000
SG00000000G00000T000
0G0000S000S00GT00000
00000T00000000000000
0T00000S000000000000
0000000000S000000G00
G00T000000G00000000S
000G000000000G00000S
000T0000000000S00000
0000000000T000000000
00SS000000GT00000000
00SS000000000G0000T0
0000000S0S0000G00000
S0T00000S00000000000
00000T000000000G000G
0000S000S00000000G0G
000T000000G000000000
T000000000G000000000
G000000000000G000000
000000GG000T0S00000S
