000000000G00000000000S0S000GMM
000000T000000000000000000SGG00
000T00000000G00G00000000000000
S000G00TS00000000000000000000M
00S000000T00000GG000000B000000
00000000000T0000000000G000S000
000T0000000000000000000000S000
000000G0000000000000000000GST0
00000000000000T000000000000S00
000000000000000000000000000000
T0000000000000000S00000000SM00
000000000000000T00000000000000
00000S0000000000G0000000000000
T000S000S000000G00G0000B000M00
000000000S0000000000000000000S
T0000000S000000000000000000GS0
SST00000000000M0000000000M0000
G000S000000T0000000000000GB0S0
000S0000000G000000000000000000
00000000000000G000000000000000
0000000000G00T000G000000S0000B
00T00000000000GS0000GS00000000
T00000000000000000G0000S000000
0000G0000000000S0000000000T000
00T0000S0000000S000000G0000000
00G0000S0000000000000T0000S000
0000T0G0000S000000SG0000000000
000000000000S000000S00M0000M00
000000000000000S0S00T000000000
S00000000000000000000000000000
