S000Sg00000000000000000M00g000
0000000000000000g00S000000g000
000S000tg0S0000000000000M00000
000t0000g000000000000g00B00000
00tS000g00000g0000S0000000B000
00000St00000000S00000000000000
000000000000000000000000000000
t00000S000S000M00000000000M000
00t000000g000000000g0000000000
0S000S00000000000000000t0g00M0
00000000S00000000tSM0g00000000
00000000000t00g0S00gB0BB00SB00
00000000000000gt000000000g0000
0tS0000S000000000000000000M000
00000000000000000000000000000g
00000000000000000000000g000000
0000000000t0000000000S0g000000
00000000000000000000S000000000
000t00000000000000000000000000
0000S000000000000000gg00000000
0000000000t000g0000g000000B000
000S000S0000000000000000t00000
00000000000g000000000000000S00
00St0000S000000000000M000g0000
000g0S0S0000g0M000000t00000000
000g000000000gB0000000000S0000
000000000000000000000000000000
g000000000t00S0000000000000000
0000t000000gS000000000S0000000
0000000t000000000gg00000000000
