0GTGS00S0000000C0000
00000000000000000000
00000T000000S0000000
G0S000000000GST00000
00000SS0000000000000
000T0000000SS00G0000
000GG00000000000000S
SS00000000C0G0000000
00000000S000S0C00T00
00T0000S000000000000
0S000S00000000000000
S0S00000000G00GT000C
00000000000000000000
00000000000T00G00000
0000G00TG0SS00000000
0000000T0G0G00000000
000T0000000000000S00
G00SG0T0000000000000
000000S0000000000000
000000000000000G0000
