T0000000GG000000S000
000SS000000G0C0T0000
000T000G00SS0000000G
00SS0C0000000000TG00
00000000000SS000G0G0
G0SS000G00T000C00000
T0S0000000000S000C00
000T00000000000S0000
00SS0C0000000000000T
0000000GGT0000000000
000000G00T0000000000
000T000000G000000000
0000000000000SSC0000
0000000T0S000G000000
00ST0000000000000000
0G000S0T0000S000000C
0S000T000000000S0000
0G000TS0G0000S000000
0G00T00S000000000S00
00000SG0000000GT0S00
