0000G00T0000000G0000000000000S
000000T00G0000000000000S0000S0
000T0000000S0G0S00000000000G00
0000000000000T000000000G000000
0000S000S00000T0000G0000000C00
00T000000000000000000000000000
0000000S0S00000G00CGT0H0000000
000000000000T00000000000000000
000000G0000000T00000G000000000
T00000000000000000000000000000
0000000000T0S000GG0S0000000000
0S0000000000000S00T00000000000
000000000000SS0000000000000000
00000000000G00000000000S000000
0000000000000T000000000S000000
000000000000S000000000S000G000
G0GT00000000000000000000H00000
000000GG000HST000000000000S000
00000G000GS0000HS0000000000000
S0000000000000G0S0000000000000
00S000000000S00000TC0000000000
T00000G000G0000000S0000000S000
000000000S00000000S0000C0G000G
000T0000S000000000000S000C0000
000000G00G000000S000000S00H000
000000000000GS0000000000000000
000000S0000000000000000000S000
00S0000G00000000T0SC0000000000
00000000000GT0S000000000000000
T000000S0000000000000000000000
