00000S0000000S0000000000000000
00000S0000g000S00000000000Mt00
0000000g0000000S00000St0000000
000SS0t000000g0000000000000000
00000000000g000gB000000000B000
0t0000000000S00000g0000000g0B0
000000S0000g000000g00t0B0000B0
000000t0000000000000000000S000
0000000000t0000g00000S00000000
000000000000S00000t0000g000000
0t000000000g0000S0000000S00000
0000000000S00S0t0000000000M0M0
0000S0000000000g000000gB000000
00000000S000g0S00Mt00M00gM0000
0000000000000000000g0000000000
0000S00S00t00000000g000000M00g
000000g0t000000000000000000000
0000t000g000000000000000000000
0000000000000g0S00S00g0B000000
000000000000S00g0000000Sg0000M
000000000000000t00000000000000
t0000g000000000000000000000000
0000S00S000ggt0M0M000000000000
000S00000g0S0000000t0000000000
000S000000000000000S0000t000M0
0000S000S000000g000000t0000000
S0g00000000000000000000000t000
000000000g000g00000000B0000000
000000000000000t00000000000000
00S0000g0t00000000g00000000000
