T000S00000000000S0G00000000000
S00000G000S0000GC0H000H0000000
000000000000000000000000000S00
0000000000T000000G000000000000
0000G0000000000T0000000000000S
0000000000000000000000000S0000
0000000S000000000000000000G000
00000000ST000000000G0SG0000000
S00T00G00000000000000000000000
000000000000T0000000G000G000S0
000S0000S000000000000C0000G000
000G000000000000G00000000000S0
0T000000000000G000000000000000
0000G000000000000S0000000S0G00
G00S0000G00000000S000T000000C0
0000T000000S0S000000G000000000
0000TS000000000000000000000000
00S0000000000000000000S0000CC0
00000S0000T000000000000000G000
0000000000000T0000000S00GG0H00
0000000000S00T00000G0000000S00
0000S0S0G0000000000000T0000000
0SG00S00000G0000000000C0000H00
00T00000S0SG0000G000C000000000
0000000000T0S00000000000000000
000000000000000000000000000000
G0000000000000T00000S000000000
0000T00000000000S000000000G000
000000000000TG0000S000S000C000
0G0000000000000000GH00H0000000
