000t0SS0g0g00000000000M0M00000
0tg0000000000000000000000000S0
000000g000gB0t0000000000000000
000000000000000000000000000000
00000000000000g000000000000000
00000000g0000000000000000t0000
0000000S00S00M000000000000M000
0g00000gBS000000B0SM0M00000B00
000S00000000000000000000000000
0g000t0g0B00000000S00000000000
00000000gt000000000g0000000000
0000S000000000S000t0000000M000
00000000tS0g00000000000000S000
000000000S0S000t00000000000000
000S00000000000000000000g0tS00
0S0000000000000000g0000000S000
00g00t0000000g0000000S000000S0
0S0St000g0000000000000000M00g0
0000000000SSg00000000000000000
000Sg0000000000000000000000000
0000000g00000000t00S0000000g00
0000g000t0g0000000B00S0S00M00B
0000000000000000000000S0000000
0000000000S00S0000M00000000000
S000000S0g00g000000000t00000B0
000000t000S00000000g000000g0S0
0000t0000000000000000g00000000
0000000000S0000S000000000g0t00
0S00000000000000000000000000t0
S000000000000S00M000000000t000
