0000000000000000000000000S0000
0000t00g0000000000000000000000
000t00000000g000000000000000gB
000000000000S00S0000t0000000M0
0g0000S00tg0000000S0000MB00000
0S0000000t000g0000000000000S00
0gg00000000B000000S00000000000
00g0000000000000000g000000000S
0g0000g000000t0000000000000000
000S00000000St0000000000M00000
000000000t000000000000000000SS
ggB000S00000000B000B00000S0000
t0000000000000000000000000000g
00000S000t0000000000000000000g
00000000000000000t000000000000
000000g0000Sg000tS000000000000
0t000000000000S000g0000S0000g0
S00t000000000000000000000000g0
t000000Sg00000000S0000000g0000
t00000000000000000S000S0M0g00M
00g0000g0B00000S000000000S000t
0000000000S0000000000000000t00
0000g0000000000000000000g0B000
0000000t000S000gg0B0000000S000
0g0000000000S00000000000000t00
00000000S000S00000000g00t00M00
000000S00000000000000000000gt0
00000t00g000000g000000000B0000
000g0000t000g00000000000000000
0S00St0000M00000gg000000000000
