00000t0gg00000000000000000000B
0t00000000000000000000g00S0000
0000g000000S0S00t0000000000000
gS00000000t0000000000000S00000
000000000000000000S00g000t000S
0t000000000000000000000000S000
00000000000000S0000000000t0000
t00000000000000g00000000000g00
0S00t0000g00g0000S00B000B00M0B
0000tS0g000000000000000S000000
0t00000000Sg0000g0000S00000000
00000000000000000g000000000000
t0000000000000000000S000000000
0000t000000S0g00g0000000000000
t0S0000SM0g00000000000000g0000
0000000000000g0g0000000B00t000
000000000Sg0000S0g000000000000
0t000000000000000000S000000000
000S000t00000000000S00000M0000
000000000000SS00000M0000000000
0000000000t0SS00000000g0000000
00000S00000g00000g000000000000
00000000000000St0000S000000000
0000000t0g0000000S000000000000
00000000000000000gS0000g000000
000000S000g0g00000000B000000S0
000000S0000t000g0000S00000000g
00000S0S00000g00000000000000M0
0S00g00000000000S000000000000g
00gg0S000SB0000000000000000000
