G0000G0T00000000H000000000000S
000000T000G000000G000S00S00000
00000000S0000000S000000C000C0C
0T00S00000000000S000000G0G0000
G000T0000000000000000000000000
T00000000000000000000000000000
00S0T00000000000G0000000000000
000S00S0000C000T00000C00000000
0000000000T000000000S00000S000
0000S0G00G000000000000000SH000
0000000S0000000G000000000000T0
S0S00000000G00000000000C000000
0000000000000000000000000T0000
000000G00000000000000S00000000
S0T000GG0HH000S000H00000000000
00000000000SS00000000000000000
00000000000000000000T0000SG0S0
000S00000000000000000000000000
G00000000S00000000G0T000000000
00S000000000G00000000000000000
00000SG000T00SG0000000000C0000
000G0000S0000000000T0000000000
000000000000000000000000000000
00000000000G00000G000000H000H0
T0000000000000S000000000000000
00T000000000000000000000G00000
0T00000000000G000000000000S000
00000000000000000T000000000000
S00T00000000G000000000G000000H
0000T00000000000000000000G0000
