0G0G000T00S00S000000
0000000T000000G00000
SS0000TG000000000000
00S0S000000000T0G000
0000000G000000TG0000
T0000000000S0S0G0G00
00S0G000000T000G0000
0T000G00000000000000
0000000000T0000G000S
0GGT00S0000S00000000
T00000000S00S0000000
0SG0000G00000T000000
00G0ST00000000000000
0T000S00000000000000
00G00000000000G0ST00
00T00S0000000G000000
00000S000000000S0G00
0G0000S0G000TS000000
000000T0000G00000S00
TG000G0S00000000000S
