000000000000000000S000000G0000
0T000SG00000000S000000G0C00000
00G0000000000G000000000000T0S0
T0000000S0000000000000S0000000
00G000S0000000000000000G000000
0000000000S0000S0000C000000000
S0000000000G00000S000T00GH0000
000000000000000000000GSGT0000S
00T00000000000000G000G000S0H00
0000T000000000000000S000000000
00000S0000000G000000000000T000
000000G00000000000000000000000
G0000000TS00G00000000H00000S00
00G000000000000000000G000H0T00
000000000000000000000000000000
000T00000000000G000000S0000000
0T0000000G000000S0000S00000000
00000ST00000S00C00000000000000
0S0T00S00000000000G00000000000
000000T0000000000000G0000G000H
000000000000000T0000S00000000S
00G000000000000000000000S00000
0000000S00000000000S000G00C000
00000000000T000S000000000GSC00
000S00S0000T0GC000000000000000
0000G0000000000S0000T000G00000
00T000000000S00S0000000C000GG0
000000000000S000000S00CG000000
0000G00000000T0000000000000000
000T0000000S00000000000000SC00
