0T00000000000000G0000000000000
T00000S0000000G000000000S00000
0000G000000000000S000000000000
000T0000G000000000000000000000
0000TS00000S00000000000000000C
0S0000GT0000000000000000000000
00000000000ST000G0000S000000G0
000000000000000000000T000G0000
0000S0G000T0000000000000000000
0000000000G0000S0T000G0000H0H0
T00000000000000000000000000000
00S000GT00000000000G000S000000
00000000G000S0000000GTH0000000
0S00000000000T000000000G000000
00G000000000000000S0G000000000
0000T00S000000000000000000G0S0
00000G0000000000T0000000000000
00GGT000000H00000000000S000000
0000000000000000SG0000S0000T00
00000000TGS00000000000S0GC0000
00000000S000G00000000000GH000H
0S0000000000000000000000000000
000000000000G0000T0S000000G000
000000000000000000000000000000
0000000G0S00G00T00000000000000
000G00000TSS000000000000000C00
0T000000000000000S00000000S000
000000000T00000S00G00000G0S000
0000S00000000T000000000000G00G
S0000000GS0000T000000000000000
