0000000G0S0000000ST0
000G00T0000000000000
00000000T000000000G0
000T0000000GG0000000
T0000000G0SS0000G00C
00000000T00S00S0C000
000S00000000G000S00C
0000000000000000000G
000000000T0S0000S000
TG0S00S0000C00000000
S0T00000000000S00GC0
GG00000S000SC0000T00
S00000S00CGG00000000
00000G0000G000S00S00
000TSS00C00000G000G0
000T000000G0000000S0
00T000000S0000000000
00T0S0000G0S0000000C
0T00000000S000000G00
0G00000G0T0S00S00000
