000GT000000G00000000
0000T0000S000000000G
S000S0000000G0000T00
0000000ST00G00000000
00000000S00T00000000
0000G0000T000000000S
GG000000000000000000
0000000G00000G000000
000G000000000000G000
0000S000000T00000000
00G0S000GT0000000000
T0000S0G0S000G000000
00T00G0000S0S00G0000
000S0000S0G0G0000000
0SG000000000000000T0
00S000000000000G00SG
S0000S00000000G00000
0S000000000000000000
G000000000GT00000000
0G000S0T0G0000000000
