000000T0S0G000000000
000000000S0T0G000000
S00000000S0000000G00
00G000G0000000000000
00T0000000000000GG00
0T0G00S0S0G000000000
00T000G000S000000000
0T00G000000000G00000
S0T00000000000000000
0000S0000G000G000000
G00S000000000000000G
0S00000000S00000T00G
00G00000000ST0S00G00
0000000TG0000000G000
000S000000G000000G00
0S000S000000000T0000
0000000000000G000000
00T00000SG0G00000000
00000000GT00S0000000
0G0000T0G000000S0000
