0T000000000S0S000000
00000T00S00000000G0S
0S00000000000000S000
00000000000S00000G00
S000000000G000000000
0G000G00000000S0S000
000G000S0S0000000000
G000G00000000S000000
0S0000000GS0000T0000
TS0000S0000000000000
T0000G0000S0S0000000
0000T0000S000S00000G
G00S000000000000GT00
00T00SS00000000000G0
S0000000G00000000000
0000000000T0G0000000
0000000GS0T000000000
0T0G00G0S000S0000000
00000G000G0000000000
00G00000S000T0000000
