0ST000000000000000000000000000
G00000000000ST0000000G00000000
0000T0000000000000000000000000
00000000G000000000G00000000000
0S000000000T0SC000000G00000000
0S000000000000T000000000000000
000000T00000000000000000000000
0G000S000000000ST00G00000000H0
T0G000000000000000000000000G00
0000G0000G00000000000000000000
000S00000T000S0000000000000G00
00000000000G00000000T000000G00
T00G0000000000G000000000000000
0000S0000000000000000000000000
000G00000000000000000000000000
00000000000000000T000000000S00
0G00000T000000G0000000000H0000
00TG00000000G0000000000H000000
00G000000G00000000000000000000
00000T000000000000000000G00S00
0000000T00000000S0000000G00000
SG00S0000GC000T000000000000000
T0000000G000000000S0000000000S
00000000000000SS00T00000000000
000000T000000000SS000000000000
000000000TG0000000000000000000
0T000000S000000000000000000000
000000TG0000G0000S00S0C00H0000
S000S000T0C0000000G00000000000
0G0000S00G0ST000H000000000C000
