00T000000S0000000000
000S0S00000000000C00
000G00000000G000000T
0TG0000000G000000000
0000T000S000S0000000
000G00T0000000000000
00000000S00000000000
00G000000000G0000000
00000000G0000000S000
000S0000T00000000000
00SGG0S00000C00000T0
000000G000S000000000
0000000000G000000000
0000000G0T000000000G
000T0000000S00000000
000G00T0000000000000
00TSG000000000000000
0000TG0G000000000000
SG0000S00000C000T000
00000000T00000G00000
