S0000000S000T0000000G000000000
000S0000G00000T000000000000000
0S0000000000S000000T0000000000
0000000000000000S0000000G00000
0S0000T0000S000000000G00000GH0
0S0000000000000000000000000000
000000000000T0000000000000S000
00G0000000000000T0000000000000
G00000G0000000S000000T00S00000
0GG00000000000H00000S000000000
00S000000000000000G0G0H000T00S
0S000000000G00TS000000000CC000
00G0000G000S00T000000000000000
000TG00000S00000S00000000C0000
00000000000000TS0000G000000000
0TG0000G000000H000000000000000
00000000000000000G0000G0000000
G000000G0000000000000T00SH0000
000000000000000000S00G0T00G000
0000000000000GG000SSCTC0000000
0000000000000000S000000G000000
0000000G0000G0HS0H000000000000
00000T0S0G00G000000000000S00H0
00G00000000000000000000S000000
0000000000000000000S0G00G00000
000000000000000000000S00000000
0000000000000000T000S000G00000
G0000000000000S000000000000000
0000T0000000G000000000000S0G00
000000000S000000000000S00000T0
