T00000000000000000000000000000
00000000000T000000000000000000
0000S000000S0000000000C0000000
0S000000000GSTC000000000000000
0G00000000000000000T0S00000000
000T00000000000000000S00000000
0000000000000000000T000000S000
0000000000000000000000000G0S00
000000T000000000000000000S00G0
000000G00000G0000000000000T000
0T000000000000000000G000000000
0000000000000000000000000000SS
T0000G00GH00S00000000000000000
0000000T0000000000000000000000
000T000G0G0000000000000000H000
00000000000000000S0000G0000000
S0000T000000000000GSC0000G0H00
0000000S00000T000S00000C000000
00000S000000GT00000000000000S0
0000000000000000000G000SS00000
00000000ST00000000000G000000G0
0000000000000000S0S0000C000000
G00000G0S000000000000S000C0000
000000G00000GS000000S00000000T
0000000000000000000G000S00T000
000T00000000000000000000000000
00T0S000000000000000000000G000
0G0000T000S000000000S00C000000
0000000S00000G0000000T00000000
00STSG000000000000000000000000
