000S0S00000000000000
00000000T0000000S000
0000S0000000000T0000
ST000000S0000C000000
0000000000000G000G00
00S00000T00000000000
00S00000000ST00G0000
0S0000S0000G00000C00
G00S0000000000T00000
0TGG00S0000000000000
00T000000G0000000G00
00ST00000G0000000000
00S00000G000000T0000
000000000000T00G0000
0000T00S0SC000000000
0000000T000000000000
000000T0000000000000
00000GS000000S0T0000
000G000000000000000T
0G00S000000000000000
