00000G0000S000G0000T0H0S000000
00000000T00000G000000000000S00
0S0000G0000000000G000T0000H000
0T00G000G0000S000000000000H000
G00000S00S0000000000000C000000
T000000000000000G0000000000000
0000000T00000000000000000S0000
000G0G0000S0000000T000000000H0
0000S000000T000000000000000000
000T00000000000000000000000000
00T00G00000000000000000000000G
00000T000000000000000000000000
000S000000000G0T00000SC0000000
000000000000000000000000S00000
0000000000G00000000G0000H00S00
000000000G0T00000000000G000000
0T000S000000000000000000000000
00G0000000S00000000S0C000000G0
0000000G000G00S00000S0000C0000
ST000000000G00000000G000000000
0000S0T000000000000000000G0000
0000T00000G000000G00000000S000
0000000000T0000000000000000000
0000000000S0000000000000000T00
G000SS000000000000G000000000H0
0000TS000000000000000000G00000
T0000S000000000SC0000G00000G00
0000S0000000000000T00000000GS0
00T000000000S0000000G000000000
000000000S00000G00000S00000000
