00000000S000G00000000000000000
000S000S000000000T000000000000
00S0000SC00000000C0CG000G00C00
000000000000000000T000000000G0
G0T00S0SCG00C00000000C00000000
T000GS0000000G000000000000000H
00STS00000000C00C00C00000000CC
00000G000000000000000G0000000T
0G000000000G000000000000000000
S000000000000G000T000000000000
000G0S0000000000S000000000G000
0000000000000000S0000000000000
000T00000000000000000000G00000
0000000S0000000000000S00000T00
000G000G0S00000T00000000000000
0G00G00000H000T0S0000000000000
G0000000GS0000000000000000H00T
000G0000000T000000S000G0000S00
0G000000000000000000S000000000
000000G000000000G0000000000000
000000000000000000GSG00000S0T0
0000000T0G0S00S000000000000000
0000000G0000000G00H0000H0000H0
000TG00000000000000G0S00000000
000G00T00000000000000000000000
00000000000GSS00000C0000000000
00000000000G0T0000000000S00000
0000S0000000000000G00000000000
00T00G0000G00S0000000000000000
00000000000000000S00T0S0000000
