00000000000000000T000000000G00
00000000T000000000S0000GG00000
00S000000000T00000000000S00000
000000000000000000G0GH00000000
00000000000000000S00G00ST00000
000000000G00000000000000000000
0000000000000T0SS0000000000000
S00T0000000S00000C00000000000G
S00G0000000000T0S00000C0000000
G000000000000000000000T0000000
00000000000T00000000000S000000
0T00G0000S0G0S0000000000000000
T000000SS0C00C0G0G0000C0000000
000S0000000000000000G0000S00C0
0000000000T0000000000000000000
00000000000S000000000000000000
0000T000000000000SG0000G000000
000G0000000000000G00000ST00000
0000000S000TG000000000SG000000
0000T000000G000000000000000000
0000000000000000T000000G00G000
00T000000000000000000000G00G00
0000000000T000G000000000S00000
0T000000000000000000000000S000
000000000000000S0T000000000000
0S0000000T0S000000000000000000
000000000SS000T00000000000G0G0
000000000000000000000000000000
G00000G00H000H0000T0S000000000
0T0000G0000000S0000S00000000G0
