S0000000G00G00000000
000000000000000G0000
000ST00G0G000000S000
000000G00G0S00000000
G000G000000000T00000
T0000SG00000G00000S0
T00S00S0000000000000
000SGTG0000S00000000
000G00T00000GS000000
00T0S0000G000G000000
00T00000000G0G000000
S000G00000000000TS0G
00000000S000G00G0000
0000S00T000000000000
TGS00000000000000000
0000000000G000S0GT00
0000TGS00G0000000000
0G0T00000S0G0000S000
00000000G000S00000T0
0T0S000SG00000000000
