000000SS000000000000
000T00S0000000S00000
S0000G00SC0000000TG0
0G000S000G0000T00000
0000G0S000G0T0000000
0000000000SS0000CT00
000G000000000000S000
00000G0000000S000000
T0000S000GSC0G000000
00T00000000G00000000
000S0000G00000S000G0
000SG00G000000S00000
00000000000000G00000
00000SS000T000000000
0000000T0S00000G0000
000TG0000S0G0S000000
0000000SSG000000T000
G00T000000000S000000
TG00000000S000000000
0G0000000000T0000000
