0000GG0000T0000S00000000S00000
00000000000000000000000S000000
00000000000000000000S0000G0000
000000000000000T00000000000S00
G00T0000SG00000000000H00000000
00S000G0T0000000000S0000C00000
0000000000G0S000T0000000000000
G00000G0H00000000000000000000H
000000G00000000000000T00000000
00SG0S00G0C0000000T00H00000000
0000000000000000000000000G0G0S
0000000000000000000000000S00G0
00000000000000000000000000000T
T0S0000G00000000000000000S0000
0S0G0000T0000000000G00000S0000
00G000S000000TSG000000C00000H0
0000GT0000000000000S0000G00000
000000000000000000G00000000000
0000000000000000000000S0000000
00G00000000000000G00000000H000
SG000T000000000000G0000S000000
00SS00T0000000000000G0C0000000
000000S00000SG0C000000000C0000
0000000000000000000000S00G0000
000000T0000S00000000000000S000
S0000000000S00000C000000000000
00000000000T00000000000000000G
00000000000S0T000000G00G0H00H0
0000000000000SS000000000000G00
0S00000G0000000T000000S00C0000
