S00000G00000S0000000T00000C000
00G00G0HHT000000H0000000000000
0G0000T000000000000G000000000S
00000000000000000G000000G0000H
00000G000000000S0000S0G0000000
000000G0000GT00000000000000000
00T0000000000S0000000000000000
0G00000S0000000000000T000000G0
00000S000000TG00000S00C0000000
S0T000S00000000000000000000000
0000000T00000S000000000000S000
00S0T000G000S0000G000H00C00000
000000000000000000000000000000
ST00000000000000G00S0000000000
0000000G0000000S00000000000000
000000T0G00000000000000G000H00
0000T00G0S000000S00000000C0000
0G0000000000000000000000T00000
000GT0000000000000000000SG0000
T00000S00G0S0000000000000000G0
0000000GG000H0H000000000000000
0000000S00TS00000000000000000C
00000S000T00000000000000000000
000000000T00000000G00S00000000
0000000000000000G0000000000000
000T000000000S000000000GS00000
0000GG00000000STH0000S00C00C0C
0T0S000000000S0000000000000C00
G000T000000000000000000000000G
0G000000GT00H0000H00S000000000
