000G00T000S0000000000000000000
00000000000000000000000T000G00
00000000000000000T0GS000000000
00000000000000000000000000T000
G0000000000000000000000000S000
000000T000000000G0000000000000
0000T0000000G00000000000000000
0000T0000G00000000000000000000
00000TS00000000000000000G00000
0G0000000000TS0S00000000000000
00G0T00000G000000000SSB0000B00
00T00000G000000S0S000000000G00
00000000000T00S00000000S000000
S0000G000T00000G00000000000000
0000000S00000G00S0000G0000000T
00000000S0000000G0000000000000
0000T0000000000S0000S000000000
000000S0000000G000SG0000B00000
00G00000S0S0000000000000000000
00000000G0000S00T00000000S0000
00000000000000000000000000SS00
000TG0000000000000000000000000
0000000000T0000000000000000000
00T00000000000000S000S00000000
T0000000000000GS00000000000000
S00000G0000000S00000000T000000
T000S0000000000S000000M0000000
G0S000T00000000000000000000000
000000000000T000000SG000000000
000000S000000000SM000000T00000
