00000000t00000000000000000g00S
ggB0000000000000B000S0t0000000
00000000000g00t00000g000000BS0
00000000000000000SS0000000g000
000000S0000g0t000000000S000000
000000g0000000000S00t00000g0B0
0g0S00g0B00000000000B0B0000000
000t00S000S0g000M00000000000M0
0000000000000000S0000000000000
g0g000S00000B0BB0S000B0000BM00
0000S00000000000000000000000g0
00000000000g000S00g00S000B000M
00000000000000t000g0g0000000SS
0000g00000000g0000000B00000000
00000000t00g00000000000g0000S0
00000000000000000000000000gS00
000000S0000000000000t000000000
000S00000000tS0000000M0g00MgM0
00000000g0000000000000S0000000
00g000000000t0S0000000000Sg000
000000000000000t0000S00000000S
00S0000000g000000000000000g0Bt
000000000000000t000S000000Sg00
00000000000g000g0000000000B0t0
00000000000000g0gt0000000B000S
000g00t0000g000000000000000000
0000S00000000000000000g000000t
00000g000SS000000000g0000B000B
0t000S00000000g0000000S0000000
0000t000000000g000000000000000
