00000000000000S0000S000M000t00
0000000000000t0000000000S0000g
00000000t000000000000000000S00
000000000S00S0000M0000000000M0
0000000t0000S000000000000000S0
0000t000S0g0000S0g000000000000
00000000tg00000000000000000g00
S000000000000000t0000000000gg0
000g000g0000tS0000000000000000
0000t00g000000000000S000000S00
0000000000000t00000000000000g0
g0000000000S00t000000000000000
S0t00S00000g0000000000000000g0
0000000000000000000000000S0Sg0
0000000000000t000000000000S0S0
S0g00000000g000000000B0S000000
0g0000000000S0SM0000000000t00M
0000g0000t0000000g000000000B00
00t0000000000000g0000g0B000000
00t000000000gS0g00000000000000
0000000t0000000000000000000000
00000000g000000000000000000000
0g0S0S00M00t000000M000000g0000
0000000000000gt000000000Sg0000
00t0000000S000000000000000000g
00t0000000g0S00000000000000000
0S0000g000t0000000000000000000
00t00000000000000000000S000000
00t00000000000g000000g00000000
000000000000000000t00000000000
