000g00000000S000000S00000000t0
00000t000g00000000S00000000000
00000S000000000000g0S000000000
0S0000000000000000000S0000t000
0g0000000000000000S000000000g0
0S00gt000000000000000000000000
000t00000000000000000000000000
00000S000000g00000g0000t000000
0000000tS0g0000000000000000000
0S0000g000000000000g0000000000
000000000000000000S0000000000t
000000000t00000000000000000000
000000S0g0000000000g0000000S00
000000000000000000gt00g0000000
0S00000S00t00000000M0000000000
S0000000000000g00000tg00B00000
0g00000S0g0000000t000000S0B000
g0Sg00000000B0000tB00000000000
00000000000S00000000000S0t000M
000000000000000000000S000S0000
00000000000g000t0000000g000000
t000000000000000000000000000S0
0000g00g0000000000000000000t00
g00g0000000t000S000000000B0000
g00g00000000000t00S00000000000
00t0000000000000000g000000S00g
0S000t0S0000000000000000000000
g000000000g0000t000000BS000000
00000000000000000000000000t000
00g000000t00000000000000000000
