00000T000G0000000000000000S000
000000000000000S00000S0000G000
T000000000000SG000000000000000
0000T00000000000S0G00000000000
000000T00000000000000000S00000
0000000000S00T00000000S0000000
000000000000000S000T0000000000
000000T000000000000G000GHH0000
000T000000000000000GS000000000
00G000000S00000000000000S00000
000T00000000000000000000000000
00000T00000000SS0C000000000000
000000G00T00000G00000000H00000
T00000000000000000000000000000
00000000S000000G0000000G000000
0000000000000000000000G0GH0000
000000000000000S0000T000000G00
000000G0S00T000000S0000000G0H0
000S0G000000000S00T00000000000
00000T000000G0000S00000000000G
000S000000000000000000000TS000
0000000000000000000T0G00000000
G0G00000S000000T0000S000000H00
G0000000000000000T000000000000
0000000000000000000000000000G0
00T0S0000000000000000000000000
000000000000000000000000000000
0G000000T00000G000000000000000
0000S000S000000000T00G00000000
000000000000S000000T000GGH0000
