00T00000000G00000000
000T0000000000S00000
0000T0000000G00S0000
SGGT00000000000S000C
00GG0000000SS00000T0
0000000000S00S00000T
0T0000000000000S0S00
00S0000000000000TS0G
000000G00000000T0000
000G000T00GS00000000
0000000000T000000000
0GG00000000000000000
0000000S0000T00G0000
00SG0000000000000000
T0S0G0000000000G0S00
00S00TS00000C0000000
0S0G0000000G00000T00
T000G000000000000G00
00000000000000G0S000
0SG0T00G0000000S0000
