00T0000G0S0G00000000
00000T0000000G000000
ST00G0G00000000000S0
00000000G0T000000000
00000S000000T0000000
0T0000000S00000S0000
00G000000S0G0T000S00
G0G00000T00000000000
G000000000S00000G0S0
0G00S00S0TG000000000
00GST000000G00000000
00S00G0000S000000T00
000000G0G00000000000
00G00T0000S000S00000
0S00ST00G0000000G000
0000G00TS00S00000000
0000000G00SS00000T00
0000000G00000000S000
0000000G00000GT0000S
000G000T0G0S00000000
