00000g00000000t00000000000000S
00000S00000t0000000S0000000000
000000000000000000g00000000000
00t0g00S000000g000000S00000000
00000000g0000000000S0000000000
0S00000t00000S00000000gg0000M0
S00t0000000000000g0gS00000B000
gS0S0000000000Mt00000000000000
SS000000g00t000000000000000000
00000000000S00000000g00g00S000
S0000t00000S000000000000000000
000000000000S000000000000g0000
000000SS000g00g00M000000000000
000S000t0000000S00M00000000000
00000000000S0000t0000000000000
00000000g000gS0t000B000000B0BS
0S00000000t0000000gg0000000000
00000000000000000S000000S00000
0000SS000000000000M000000000g0
0t000000g000000000g00000000000
0g0000000g000000B00B0t0000B000
000t00g000000000g000S000000000
0000000000000g0000000000000000
00000t000g0000000000g000000S00
0000g00000S00g000000B000000000
000000000000000000000000SS0000
000g000000000tS000000000000000
000S00S000M0000000Mg000000Mg00
S0000g00000000000g0000000000t0
000000000000SS00000M0000000t00
