00000t00g000000000000000000000
00000000000S000t000g00g0B0B000
0tS0g0000000000000S00000000000
S0000S000000MM0000000000g00000
00000t0000000000000000000S0000
000000000t00000000000000S00000
0000000000t0S00000g00000000000
0g0000000000000000000000000000
00000000g0000000000000000g0000
0000000g0S00000S0g000B00t00000
000000g00000S0000000000000SMM0
00000000000S00000000g000000g00
000g0000g0000000000S0000000000
0gg000000000000B00000000000000
00000t000000000000000000000S00
00t000S000000000g0000000000000
00000t00000000000000000S000000
0g00000000000g000S00000000000B
000000g00g000000S000000B00t000
00g00000000g0tS000000000000B00
000000SS0000000000000000t00g0g
0000g0g000000000B0000000000000
00000000000000000g0000000t0000
00t000000000g00000Sg0000000000
00g00000000000000000000gB00000
000S00S0000M0000000000g0t00000
0000000000000000000000t0000000
000S000t000g000000000000000000
00000000g00t000g0000S0000000S0
000000S0000000S000000000000000
