0000000T0S000000S000000000C000
0G0T000G0S00000000000000000000
T0000000000000000S000000000000
0T0000000000000000000000000000
000S00000000000000S0000000T000
00000GS00000G000S00C0000000000
0000000000SGS0T00000000C00000G
000000G0000000T0000000000G00S0
000G0000000000000000000000000S
00000G00000T000000000000000000
00000G000G0000000000000000000T
0000000S00000000000T0000000000
00T000G00S00000000G00000000000
0T0000000000000G0000S000000000
T000000000000SS000000000000000
T0000000G000000000000000G00S00
000000000000000G000G00HT000000
S00000000000000000000000000000
0G00000000GH000T0000000000000S
GG00000000H0000000000000000000
00S000000S00000G0000000000G000
0T0000000000000000000000000000
000T0S00000S000G0C00000G000000
0000000000000G0000000G0000S000
000000000T000000000000000G0000
T000S0000G00G00000000000000000
0000GG0000H000000000TS00000000
0000000000000000G000S000T0G000
00000G000S00000000T0G000S00000
00G00000000G0H0000000T00000S00
