000000G0000T00000000000S000000
000000000000000000000000000G00
000TS000000000000000S000000000
0000000S0000000000000000000000
000000S00G00TS000000M000000000
000S00000000S00000000000000000
0000000000S00000000000000G00T0
00000000000000000000S0G0G00000
000000S00000S0T00000M00G000000
0000T00000S000000000000S0M0000
00T0S0000000S0000000000G000000
00000S00000G0000000000000S0000
000000000G000S00G0B000B0000000
000G000000000G0S000T0000000000
0S0T0000000000000000G0000000SG
00000000S0G00000G0000000000000
000T00000000000000G00000000000
S0000000S000000G00000000000000
0000000T00G000000000000000000S
S0000000000000000G0000T0000000
0000000T000000000000S0000G0000
0S0T00000000G000000S0G0M000000
000000000000000000000TG0000000
00000G00000000000S000G000B0000
000S000000000000000000G0G00000
T000000000000GS000000S00000000
000000000000G00S000S0000000000
00000000G00000GT00000000000000
00000000000000000000000000S00T
000000G00000G00000S00000000000
