000T00GG000000000000
00000000TGS00000000G
000000000G000T00000S
0T000000000S00000000
000GT000000000000S00
TG000G00000000000000
0G00000G000000000000
0T000000000000S00000
0000G00G0S000S000000
0000000000S00G000000
0T00000000G0000S0S00
GGS00000000000000000
000S000T0000000000SG
0G00000T000000000000
00000S000GGS00000000
0TS0S000000000000000
0000T000000000S00G00
0S0000000000G000000T
00000T000000000G0000
000T00000000S0GS0000
