0T0000S0000000G00G00
0000000S00000000S000
T00000S0000000S00G00
T0000000000S000000G0
SG0000000000000000G0
0000000G00S00T000S00
0G000S00T00G00000S00
000S00000000SC0000G0
0T00000S0S0C00000000
G0S00S00CG0T00000000
00G00S00S000000G0000
00G00S000000G0000T0S
0G000T00000000S00G00
000G00000ST000G00000
0000S0SGG0000000C000
GS00SG00000000000000
000000000SSC0G000000
00SG0T0G000000000000
0T0G0SS0000000000000
00000S000G00GT000000
