000000000000tS0g0000S0000M0000
t0S00000000g000000000000000000
0000000t000000000000000S0000g0
0S00000S000M00t000000000000M00
00000000t000000000g00000000000
0t00000000000g0000000000000000
000000g00000000000S000000000t0
00g000000000000000000g0000000S
000000000000000000000t00SS0000
g00000000000000000000000000000
00g000000g00St0000000000000000
0g00000000000000000S00g0000000
0000000S0000tgg000000000000000
S00S0000000t00000000000M000000
000000000000000t00000000000000
000000000000t000000S0000000Sg0
000000000000000t00000g0000g000
00000Sg00000tS0000M000000g0000
0000g00000t0000000000000Sg0S00
00000000000000000000gS00000000
00000t00000S0000S0000000000000
0000000t0000000000000000000000
0t000000g00000000g000B0000S000
000000000t0000S000000000000000
0000000000000SSM000000t0000000
0000000000000g0000000000000S0t
0S000000000000t00g000000000000
000S000000000t000g000000000SM0
SS00t000000000000000000M0M0000
S00000000000000000000Sgg00t000
