S000G0000000000000000000000000
G00000000000S00T00G0000000BB00
G0000000S00000T00000G000000000
00000S00000000000000000G0S0000
000000S000000000S00000000M0000
000S0S000M0000000000000000G000
000S000000000000GG0ST000000000
00000000000000G000000000000000
00000000000000S00G00T00000G000
00G00000G0000000000000000S0BS0
0T0000000000000G00000000000000
0000000000GTS00000000G00000000
0S0G0000S00000000000T00000M000
0000000000T000000G00000000SS0M
000T0S0000G0000000000000000S00
00T0000000000000000G0000000000
G0000000G0ST00B00000000S000000
00000000T000000000000000000000
000000000000T00000000000000000
0S000000000000000TG0S0M0000000
00000000G000000GT0000000000000
00000T000S00000000000GS0000000
00000S0S0M0000000G000G00000000
000000SS0G000M0000M0G000000000
000000000000000000000000TG0000
00000S0000SG0MT00G000000000000
00000000T0000S000S000000000000
000000000T00000000000000S00000
0000000000000S0T0000000000000S
00T000S000000G00000000S0000G00
