00000000T000G000G000
0000000000000000000G
00000T000SG000000000
00T00000000000000000
0000TG000000G0000S00
0000SS00G00000T00000
00T000000000000S00S0
0000T0S00000G0000000
0000T00000S00G000G00
00S000T00G0000000000
0000000000000000000S
0000000S00S000000G0C
00T000G00000000000G0
00G000SG000000000000
0S0000000G000T000000
0000T0000SSGC0G00000
G00000000GS000000000
00000G0000000S000000
00G000T00000G0000000
0000S0000000000SG0C0
