0T00000000000000000000G0000000
00000GT00000000000000000000000
00G000G000000T0B00000000000000
0000000000000000000T00000SG000
00T0000000000000000000000S0000
00000000S0000000000000S0000000
00000000000000000000S000S00000
0000G000000000T00000000SG000B0
000000T0S0000000GS000000000000
00S0000S000000T000000000000000
T000000000000000000000000G0000
GS00000G00000000TB00000BB00000
000G0000000000000G000000000000
0S00G000000000000000000000S0M0
0S0000000000000000000000000000
0T0G0000000S000000000G00000000
000G00000000T00000000000S0S0G0
T000000000000000000G0000000000
0T0000S00000000000000000000000
00G000000000000000000G00TB00B0
000000ST00000G00S0000000M00000
0000T00000G0000G0000000000000B
0000G0000G000S00000T00000S00M0
0000G0000000000T000S0000000000
0000S000000000000000000T000000
000G000000000000ST00000000G000
00T00000G00S0GS000000000B00000
T0G000000000G00000SS0M00B00000
0S00000T0000000000000000000000
0S0000ST0MM0000000000000000000
