000000000000000000000000000000
000T00G00000000000000000S0S000
0T000S0000G00000000000000S000G
0000000000S000T000000000000000
0000000T00000000000000000S0000
00S00000000G00T000G00000000S00
0000S000000000000000000T000000
00S0000000000000000000000000S0
00000000000000000000T000000G0G
0000000000T0000G0S000000000000
000000000000T00000000000000000
0T00SS0000000C0000000000000000
00000S000000G00000000000000000
G000000T0000000000000000000000
0T00000G00000000000S0000000S00
00G00000S000G0000H000000000000
00000000000000000000000SG00S00
00S000000G000000G000T00000000H
0000000000000000ST00000000000S
00000000T0G00000G0000S00000000
00000000S00000000000000S000000
0000S00SC000000000000000000000
000TSG00G00000H00S0000C0000000
000T000000000000000G0000S00000
000TS0000000000S00000000000000
0000000T0000S0G0000000000000S0
000T00000000G00000S00000000000
0000000000000000T00000G0000000
00000000000000000S000SG00C0T00
00000T0000G0000000000000000000
