0000000000t0000000000000000000
t000S0000000000000000S00000000
0S0t000000000000000gS000000000
0t00000000S0000000000000000000
Sg000000t000000g0S00000000000B
00t00000g000000Sg0000B00B00000
00000g0000000000t00gB000000000
000000000000000000g0t000000000
00000000t0g0gSS000000B00000000
00000000000000000Sg0S0t0000000
00000g0000S00000g00000tB000000
000000000000000000g0S000000000
00000000000000t000000g00000000
000000000S00g0000g00B0000t00S0
00S00000g00SM00t00000000000000
000000000000t00000000000000000
g0g00B00000B00000S00t00B000000
00000000t000000000000000000000
0t0000000000S000000S0Mg0000000
00t000000000000000g00000000g00
000t0000000S000000000000000000
00S000S0M000000000000g00g00000
0000000t00000000000000gg0000B0
000000Sg000S0000M0000000000000
0000000000000000g00000000000t0
g0000t0000000000000000000g0000
00t00000000g00g000000000000000
00000000t0000000000000000S0000
00000000t000g00g00000B0B00S000
0000000t000S00000000000000S00M
