0000G0000000000000000G000000T0
S00000000SGC000000000000000000
000000G0000000T0G0000000H0000S
00S000000T0GS0G00H000000000000
G00000000000S0000000000000G000
0000000000000TS000000000000000
000000S0000S000000G0T00C00G000
0000000000G00G000000S0000000S0
SG0S000000000000000000T0C00000
000S0000000000000T000000000000
0000G0G0H00T000000000000000000
000S0000S00000T000000G0000G000
00T0000000000000000S0000000000
T0000000000000G000000000G00000
00000000000000SSC0000000T00000
0S000000000GS0000C00000G000000
000G0000000000000G000000000000
000T000000S0000000000000000000
G0000000G00000H000000T00000000
0000T000000000000000000000000S
G000000000T0000000000000000000
000T0G0000000000000000000000S0
00S000T0SC00000000000000000000
000000000SS00G0G00000C00000000
000S000000T0000000000000000000
0TS00000000000000000S0000C0000
0T0000S00S00000000000000000000
00S000000000G0000000G000000000
T0000G00000G000000000000000000
000T0000000G000000000000G000SS
