g0g000S00B0000000t00000000B0S0
00000000S0000S000g00M000M00000
000000000000000000000000t00000
00t00g000000000000000g0B000000
00000S00000000S0000000000M0000
00000000t0000S0000000g000S0000
000t00000000000000000000000000
000000000t00000000000000000000
0000000gg0000000S00000S0M00000
g0000t00000000g00SBB0000000000
0000S000g000000000000000g000S0
00g0g00S0000000000St0000000000
0g000000000S0gS000000B0M00t000
00g000000000t0g0000000000B00B0
t000SS000000000000000000000g00
S0000000000t000g000000000000S0
0000t0000000000000000g00000000
t000000S000g000g0000000000000B
t000000g00gB0000000B0000000000
0g0000000000Sg0tSB000000000000
000S00000000Sg00M000t000000000
t0g00000000000g0000S0000000000
0000000g0000000t0000S0g0000000
0000S000000tS00000000000000000
00000t00g000000S000000000S0000
0000g0t0g0SB000000000000000000
0g0000000gB000000000000B000St0
000000000000000000000000000g00
00000gg00S000t00S0000000000000
0g0000S000000000g0000000000000
