t0g0000000S00gBS00000000000B00
S00SM00000000t000M00000000000g
00t0000S0S00000000000g00M00000
00g0g0t00SS0000000000000000000
0000000g0t000000000000S0S000M0
g000g00000t000000S000S000BB000
0000000t0000000g00000000000000
0000000g0000t00000000000000000
00000000000t0000000000g0000000
000000S000000000t00000000000S0
000000g0000t0S000000S0000g0000
0000000000000000000000g00000S0
00S0000000000g00000000000S0000
0t0000000000000000000000000000
0000g0000000000000000t00000S00
g0t00000g000000000000000000000
0S00000S00t0000000000M00000M00
00000000000g000t00000000000000
000000g0000000g000000t00000000
S0000S0g0000000g000000000000MM
00t000000000000000000000S0g000
000000000000000000000t00000000
00000t00g0000g0000000B000000SB
000000000000000000000000000000
0t000S000000000000000000000000
0t000000S00000000000000g000000
S0S00000000000000000000000tM00
0g0000S000000000t00000gB000SB0
00g0S000S000000M0g0000t0B00000
000000t0000g000gS0000000000000
