0T0000000000S0000G00
000G000000T000S000S0
00000000T0000S000000
G0T0000000G0000S0000
S000T000000S0000000C
SG0000000G000000S00C
00G00000S00000000G00
00000000S00G0ST00G00
00000S000000T000000G
000S000G000000000T00
0000G00GST00000000S0
G0000G0000000000000S
S0000000000000G00000
S000G00000T0S0000000
S0000000000000000000
G000000S000000G00000
0S0000000S00T0C00000
0G00G00S000S000T0000
0S000TG000000G000000
GT0000000000000000GS
