00000000000T0000000000000S0000
000000000G0G000H000000H000T000
0000000000000000000000000000T0
0GS000000000000000000T00000000
0S000S0GG000000HT0000000000000
00GS00000T00000G00H00000000000
0000000000000000000G0T0000S000
000000000000GSG0S00000T0000000
000000G000S000000000G0000H0000
00T000G00000000000000000000000
0000000TG0000000000000000000S0
00000000000SG0000000000000G000
T0000000000000000G000SS0000000
00000S00000S00000000C000G00000
00S000000000S00C00C0CG000GH00T
0000S0000000000000000T00000000
0GS00ST00C00G00000000000000000
00S0T0G000S0000000000G00000000
000000000T00S000G0000000000000
000000T0000000G000000S00000G00
0000G000S00000000S0000000000C0
00000000T000000000S00000000000
00000S000000T0000000000000S000
0000T000000S000S000000000000G0
000000G0T0000G00S000000000S000
000000S000000000000G0000000000
000000S0G000S0T000000000000000
0000T0GG0000000000000000000000
000000TG000000000000000G000000
00000000000000000S000T00000000
