00000S00GG00S00000000000000T00
00000T000S000S0000000000000000
TS00000000000G00000G0000000000
0G000000000000000S0000G0000000
0000G000000G0T0000000000000000
000000000S00000T00000000000000
0000000G0000S0G000B0000000S000
000TS00000S00000000000000000G0
0000000G00T0G00000000000000000
0000000T0000000000G0SGS000B000
000000000000000000000000T00000
00000000000000T000GG0000000000
G00000000S0000G000000000000000
0000000000T0000000000000G0S000
0000T000000000000000000000S00S
00000S000T000S0000MG0000MG000B
00T000S000000000000000GG000B00
G00T00000000000000000000G00SB0
000SG000000000SM0000T000000G00
00G0000000000S000000G0000000BT
000000GS000S00000T000000000000
000000S0000000T0G00000000000G0
00T000000000000000G000G0000000
0T0000000S00000000000000000000
0T000000G0G0000000000S00000000
G000000T00S000000G000000000000
000000G000000000000000000000G0
00T000000000000000000000000S00
000000000000000000000000000000
0G000000000S000000000S00000000
