00000S0T000000S00G000000000000
00000T000000000000000000000000
00000000T000000000000S0000S000
000000000000T000000G0000000000
00T000000000000000000000000000
0T000000000000000000000000000G
00GG00B00000S000000BT00000B000
T0000000000000G00000000000G000
000000000S0T000000000G00S00000
S00000G00000T0S0000000000M0000
000000000000T0000000000000S000
00000T0000000000000G0000000000
000G0T000S000000000000G0000B00
000000000S000000000000000T0000
T0000000000000S000000000000G00
000000000G0000S000000000000000
000000000000000000T0000S000000
00000000000000T000000000000000
0S0000000G0G0000000000B000000T
0000000SS00000M00000000T000000
0000000000000000000000GT0G0000
000000000000000000000000T0000G
S000T0000S0M000000000000000000
GG0T000000000S000S000000000000
000G0000S00G00SB00MM000000M000
00000000T0S0000000000S0G000000
00000000000000000G000000000000
00000G00000000000000000G00000T
G0G00000000000ST000000000B00B0
000000G0000000SS0000T000000000
