000000GG000S0T0000B0B000000000
S000G00000T00000000000S0MM0000
000S000000000000000000G000GT00
000000000G00S000000GS00T000000
00T000000000000000000000000000
0000000S00000G0000T00000000000
000000000000000000000T00G00000
00S0000000TS00000000000000M000
000000000T000000000G0000S00000
G0000000000000000G0000T0000000
00000000000000T00000S000G0G000
0G00000000T000000000000000G000
000S0000000000000000S000T00000
0000000000G000000000000000000G
000G0000000000000G000T0S000000
0G000T0000000000000SS000000000
00G000000T0S00000S0M000000G000
0S00000T0000G0000S0000M0G00000
00000000000GS0000TS0000G000B00
00000000T00S0000000000000S00M0
0000000T0000G0000000000S00G000
000000T0000000000G000000G00000
00S0000ST0000000GG000000000000
0000T000000G00GB000B0000000000
00S0000000000000000000000GS000
000G00000000000T0000000S000000
000000000G0S0000T00000000000S0
0000S000000000T0S0000M000M0000
00SG0000000SM00G00000000000000
0000000000S000000T000000G00000
