000TG0000S00S0000000000C000000
000000TS0000S0000000000C00G000
00T00G000S0000000S000000000000
0000S000GG0H0000000ST000000000
00000000000S00S00000000G000000
S00000T00000000000000000000000
0000000000000000GG0000S0000000
00000000TGS0000G000H00000000S0
000000SSC000000000000000000000
0S000000000000000G0000000000T0
00000T0G0000000000GS00000HS000
0T000S00SC000000000000000000G0
S000S00C000G0G0000000000000000
000000000000TS000000000000G00S
0G0000000000000GT00000000H0000
00000000000000000000S000000000
0S0000000000000T000000000000S0
000TS00G00000S0000000000000000
000ST0000000SG0000000000000C00
0ST0000GG000000000000000000S00
000000G000T0000S00000GS0000000
0T0000000000000000000000000000
000000000000G0G0H0000000000000
T000000G000000GH000000000000S0
00000000000000G00000000000S000
000000T000000000000000000G0000
0000000000000000T00000000GG000
00000000000000000G0S000S000000
00G00T000G00000000H00000000000
00G0000T00000S000000000G00000S
