00000000000G0T0S00000000000000
00T0000S0000000000000G000G0000
000G0000000000000TS00000000000
00S00000000000000000T000000000
00000000G000SG0000H00S00H00000
0000000000000000000GG00000S000
000000000000000000000000000000
00000T00000000000G000G0000H00S
00000S0000G000000000G000000000
0000000000000T000000S000000000
00000T000000000000000000000000
S000000000S0G0000000T000000C00
000G0T000000S00000G000000HS000
0SS00000G00000TG00000000C00000
0000G0000000000000G00000000000
00000000000000000000000T00000G
000000T0000000SS00000000C00000
00000G0G0000000T00000000000000
00000G0G0000000000HH00000T0000
0000000SG000000000000000000000
000000T0G0000S000S000000000000
0000000000000T0GG0000S0S000000
0S000000S0CG0G0000000T00000000
00000000000000G0000000S0000000
00S00000G000T000S000000C00000C
00S00T00000000000000000000S000
G00000000G00000000000000H00000
0000S000000G000000000000000000
000000000000000000000T00000000
000000000000000000G00GH0000T00
