0000000000G00GS000000H00000000
S0000000000G00000S0G0000000T00
0000S0000T0G000000000000S0GC00
T00000000000000000000S0000S00C
0000S000000G00SG00T00000000000
00000000S0000S0000000000T00000
000000000000000000000000000000
0T0000000GS0S00000G00000000000
ST0000000000000000G0000000G000
000S0000000000T000000000000SG0
00T0S00000000000000SC000000000
GG0000H000000H000000000T000000
0000GT000000000000GH0000000000
000000000000000000000000000000
0000000000T0000G00000000000000
G000000000G00000000H0000000000
0000G0000S00G00T000H0000000000
00000000000000000000T000000000
000T00000000G00000000000000000
000000T000000000GS000S00000000
000000000000000000000000T00000
0000000000000G000000000000S000
0000TS000S0000000000CG000000CG
000000G00S00000SG0000C0T000000
0T0000000000000000000000000000
00000000T000000000000000000000
00S00000G0000000G00000000T0000
000000000T00000000000000S000G0
00000GS00T000000G000H00000S000
0G00000000000SS0G000000T000000
