00000000T0000000000G00000S000S
0GT0000000000000000000G000B000
00G0000000S00000S000M00M000000
000000S000S0000000G00000000M00
00000000TS00000S0000G000M00000
000000S000000000000000T0000GG0
00S00S00000T000000000000000000
0000G000S0S000000000G000000000
000GS00000GS000000000T0000000B
00000000000000000000G000000S00
000S00000000000000000T00000S00
G00000000T000000000G00S0000000
00000000000S000000G00000000000
00000000T000SS0000000000MG0000
00000G000T000000000000000000S0
0S0000000000000T0000000000000S
00000000G000000T0000G000000000
00000000000000S000T0000000S000
00000000000000S000000000000000
S00000000000S00000000000000000
00ST00000000000S0M00G0M0000000
00000000S0T0000000S0000GGMM000
00G0000000000000000000000TG000
0000G0000S0S00000G00B000B00000
000000000000000000000000000000
0T000000000000000S000000000G00
00000000G00000T000000000000000
000G000S0000T0S0000000000000G0
00000000000000TG00000000000000
00T000000000GG00000S0000000000
