0000T0000S00000000000S0000000G
0G0G000000T0H000000000000S0000
0000000000T0G00000000000000G00
00000000000000000000000GG00000
00000SS0000000000C000000000000
000G00SS000000T0000000000G0000
00000000T000G00000000000000000
GT0000000000000000S00000000000
000G00000000S00000T0000G000000
000000G00G00TH0000000000000000
000000000000000000S00G0G000000
00GT00000000000000000000S00000
00000000000000000000000T0000G0
00000S0T0G00G00H00000000000000
000T000G000000G0000S0000H00000
00S0000G0000S0000000000TG00000
00000G000000000S00000000000000
00000000000000000000000S0000T0
000000T0000000000000G000000000
0T0000G000000000000000000S0000
G00000S00000000000T000G00S00C0
000000S0S00T0G00G000C000000000
000000000T0000000000000000S0S0
00000000S000000000000T00000000
TS00S0C00000000000000000000000
00000G00000000S00T000G00000000
000T0000000000000000000S000000
0000T0S00000000000SC00G000000G
0000G0000000000G0000000T000000
0000000G00T0000000000000000000
