00SG000000000000G0000000000000
0000000000000GT00000000S000000
0000000G0000T0S000000000000000
00000000000GS00000000000000000
0000GS0S000000C00000000000T000
0000000000000000000000000000TG
0000S000000000S00G000000000000
00000000000000000T000000000S00
000GS00SG00T000H0000C000000000
0S000000000S00T000000000000000
0000G0000000000000000000000000
0T00000000000000S0000000000000
00000000000G0000GH00000000000S
0GS000000000G000T000000000S000
000G000T00000000000G00000H0000
0S0000000000T000G0000000000000
000000000S000ST00000000000000C
0000000S0T00G00G00000S00000000
0TG000000000000GH0000000000S00
00S0000S00000000000000000C00T0
0000000000000000G000000ST0000G
000000000T0G000000000000000000
000000000T0000000SS00000000000
0000000T000000000000S000000000
0G0S0000000G0T000H000000000000
00G000000000T000000000000G0000
000T00000G0S000000G000000000S0
00000000000T00000S000000000G0G
00G00S0000S00T00000000C0000000
000000000G000000000T0000000000
