00S0000000000T00000S
00000000000S000000T0
0000000000000ST0000G
000000G00000T0000000
S0T000S00C00GG000000
000G0000000000T00000
00000S00000T00000G00
G0000T000S0G00000000
00000000000S0000S000
00000000TS0000G0G000
0000000T00000G000G00
00000000S0000T000000
T000000000S0000G0000
000T000G000G0000S000
0TS0S000000000000000
0G000T0000G000000000
00000000T0G000S00000
00000000000G0T000S0G
0GT00000SG00000S0000
00TS000000G00G000SC0
