00000000S000T00000000000S0C000
0000000000G0000G000H000000S000
T0000000000000000000000G000000
S00G00G0S000HC000000000T000000
00000S0000000000G00S0000000000
0000000000000S00G000S0T00000C0
00S0000T0000000G00000S0C00000G
0S00000000G0000G0000000T000000
0000000GS0T000000000000S000000
000000000000000000G0S000GS0000
000T000000000S0000000000000000
0T0S000000S0000000000000000000
00000T0G0000G0000000H0S0000000
000000000T000000000S0000000000
000000000000000000000000000T00
0000000000000000000T00G0000000
S000000000000000T0000000G0000G
000000000000G00000000000S00000
0GT0000G0000000000S00000000000
00000GSS0G0000H000T00000000000
00S000000000000G0000T00S0000G0
00G00000TG00000000000000H00000
0000S00000000000000000000T0000
000S0000000000T0G0G000H00S0000
00000G00T00000S000000S00000000
000000000S00000T00000000G00000
0000000000000000000G000000S000
000000T0G000000000000000000S00
00T000S00S00000G00C00000000000
00G0000000S00000G0000H00000000
