G00000T00000000000000000000000
00000000S0000GS000000000000000
T000000000000000000000000G0000
0000000000S000000000000000STC0
00T00000000000000000000GG00000
000SG00000G0000000000000000000
0000ST0G00000000000000000000SG
S00000000000T00000000000000S0C
0000G000000000000T000000000000
000000000T000000000S0000000000
00T0000G00S0000000000000000000
S00000T000000S0G0000000000G000
000SS000000000T0C000G00000G000
S0000000000000G000000000000000
00000000000000000000ST0G00G000
00S000000000000000000000S00000
0S000G0000000GH0S00000T0000000
000000000G0G000H0000000S000S00
000000000000T00000000000000000
T0GG00000000S00000S000H00000C0
000000000000000000000000S00000
00000T00000000G000000000000000
00000S000S000000G00000C0000000
000000000G000000000000000S0000
00000000G00000000000SS000C000G
0T0000000000000000S00000000000
00000000S00000000000000000000G
000S0000S000000C0000000000G000
0000000000000T00000000S00000G0
00000G000G0000000T000000000000
