000SS000TG0000000000
0000T0000000000000G0
T0G0G000000S00000000
000GT000000000S00S00
0000S00000000000GS00
00T000G0000S0000G000
000000T0000000G00000
00000S000G00S000000G
0000000000000000GG0T
0S00000S0T00G0000000
S000000000000G0G0000
0SS00G00000000000000
0000000G000000000000
0T0000000S000000S00G
000000000000S0000000
0000000T00000000000S
0G0GS000S00000000000
G00G0S0000S000000000
0000000000G00S0000GT
0000000S000S000G0000
