0000000000000G00000G0T00000000
GG0H000T000S000000000000000000
0000000000G0000000000S000G0000
T00000000000S000000S000C00G000
G0000000000G0000000S0000000000
0T0G00000000000000000000000000
00000000S00000S0G0000000000000
000000000S00000000000000000000
00000S0000000000T000000000G000
0000G000G00H00T000000000000000
0000T0000000000000000000000GSG
0T00000000G0000000000S0G000000
T0000000000000000000000000S000
G00000GT000H0000S00S0000H00000
T00000000S00S00000G00000000C00
00000000000000GG0S00000H00H000
00000T0000000000000000S00S0000
00000000000000000G0000000T0000
0000S00000G000G0000S00T000C0H0
000000000000000G0G0000000000H0
0000000000000000000000000T0S00
0000000000S0000000000000000T00
0G0T000S0000S0000000000000C0G0
000000G0000000G000S000000TH00H
G00000000000000T000000000SG000
0S000000G0000000000G0T00000000
0000000G00000000000T0000000000
00000000G0G000000T0000000000H0
0000T0000S000S00C00000000C0000
00000000000000000G00000000S0S0
