0000S000000000000G00
0T000000GG0000000000
00000000S00000000000
0G00G0T00S0000000000
000T000000S00000S000
00G00T0SS0G000000000
T0G0G000000000000000
00000000GS0T00G00000
T00000000000SG000000
000TGS000SC000000000
0T0000000S000S0000G0
ST0S0000000000000000
0T000000000000000000
0000000000000S000T00
0000T0000S0000000000
S000G00GSC0000000000
SS00T000000000G00000
0S000000000000000000
S00T00SC0000000G0000
0G0000T0000000000000
