0000000T000000S0000S0000000000
00000000S000000000000GG0000000
00T000S000G000000S000000000000
000000T0000000000000000000S000
00T000000000000000000000000000
T0S000G0000000000000S00000C00C
000T000SG00000000000000000G000
0G000000000SG000SC0T00000H0000
GS0000000G000000S00H000T000000
0000000000SG00000000G0H0000000
00S000000S00000000000000000000
000000000T000S000000S000000000
00G00000T00000000GS0000H000000
S00000000TS0000000000000000G00
00TG00000S000000000G0H00000S00
000000000000000T0000G00G0S0000
00000000000000G0000000S0000000
00000S000T0S000000000000000000
0T0000000S0000000000000S0G00C0
000000000000000000000000000000
00G000000000000T0000G00H000000
G0S00000000000000000S00G00000C
00000S000000G0T000S0000G00000C
0000T0G00000000000000000000S00
00S0000000000000S0000000T00000
0S0000000000000000000S00000000
0S000000G00S000000000000000000
00G000000TG00000H000S000000000
G00000000000000000000000000000
00G00G000H0000000S00000000H000
