000000000000000tS0000000000000
000000S00000000000000000S00000
00S00000g000000000S0000g000000
000g0g000000000000000000000000
t0000000g0g000000000S000000000
0000000000t0000000000S000S0000
0t00Sg000000000000000000000000
0000000t00000Sg0000000000S0000
000S0000S0000000000gM0M0t00g00
00000t000000000g0000000000g00S
00g0000S00000g00000000000000t0
000t000000000000S0000000000000
00000S000000000000000000000g00
000S0000000000000t000S0000M000
0000000g0000000000t0S0000S0000
000000000000t0S0000000000000gS
0g0Sg0000000000000000000000B0B
S000S000M00000g000g0000t000000
t00000000S000g0g0000S000000000
0t0000000000000000000000000000
0000000000000000tg0000000g0000
tS000g000000000000000000000000
0S0000S00000000t00000000000000
0t000S000000g000g00000S00000M0
0000000g000000000S00000000gS00
00000S0000000000000t0000000000
000000000000S000000S000000Mg00
0000g00000000000000S0000000000
S0000000000g000t00000000000000
00000S0g000000000t00S00g00000B
