00000000g0000000000t000000g000
0t00S00g00S000000000g0B0000000
0g0000S000000000000t0g00000000
00000000gSt0000000000S0000000g
0000000000000S0000t000000000g0
00000tg00000000000000g00000B00
0t00000000000000000g0000000000
gt0000000000000000000000000000
00000000000000000000tS0g000000
00000g000S00000000000000000000
g0t000S000000000S0000000000000
000t00000000000000000000000000
00St0g000000000000000000000g00
000000t00000000000000000000000
000000000g0000000000tS000000S0
00000000S0gS00M00000M0M00M00t0
000000000000000000g00000000000
S00000000000000000000000000000
000Sg000t0000000000S0000000M00
000000000S00000000S0000M0M0000
tS000S000000000000000000M00000
0000S00000000gg000000000000000
000000S00000000000000000000g00
00g0000S00000000000000S000Mt00
000000000000000000000000000000
t000S0000000000000000000000000
0S00000Sg0000t0g00000000000000
000000t0000000g0S000000000S000
S0000S000000000000g00000g00000
00t000000000000000g00000000000
