S00S00000000000g0000gt00000000
t0000000S00000000000S0000000M0
0000000000S00S00M00000000000M0
00000000000000000t000000000000
00000t00000g0000000000000000S0
00t00000S0000000000000g0000000
0t0000000000000g00000000000000
00t000000S0SM000g0000000000000
gS0000000000000000t00000000000
000000000000000g00000000000S00
000000000St00g0000000000000000
0t0000000000000000000000000g00
g0gB0S0000000000B00000t000000B
00S00000000000000000S000000000
000000000g0000g000t0000000000S
000000000g0000000000000g0000B0
000gt00000000000000g00S00S0000
00000000gS0000t000000000000000
t00000000Sg000g0000000000000B0
00000000S000000S0000M00000M000
Sg0000000g0000t00SB00000B00M00
00000t000000000g000SS0000g0000
00g00t000000000000000000000000
000g000000000000t00000g0000000
00000S0000000000000g0St0000000
00gS00000S000000t0000000g00000
0000t0000000000000SS0000000000
000000000g00000000000000000000
S0gS000000000M0000000000000000
000g00000000St0000g00000B00000
