T0000000G00G0S000SM00000000000
S00GT00000000S0000G00000000000
0T0000GS00000G0B0S00M00M000000
00SS00000000000G0M0000000000G0
000T00000000000000000000000000
00000S0000S000T000000000000000
000000T00S00000000000S0000000M
000G0000000000000S00GTS0000000
000000G00000000G0000T000000000
00G000000000000000S0S0T000000M
000000000000000S00000000000000
00S0000000000G0000000G0000SM00
00000000000G00G0000000000S0000
0000000G0000000T000000000G0000
T000000000000G00000S0000000000
000T00000000000000000000000000
0GS00000000G000T000000000000B0
0000000000000TS00000SM00G0000M
0000000000GST000000000G0000S00
G0G0000000B0000000000000000000
000000000000000S0000000S00T00G
000T000000000S000S000000000000
0000T0000SG0000000000000000000
G00S00000G000000B0000000000000
0000000000G000G0000B00000T0000
00000000000GT0000S0000000000G0
0S000000000S0T000000000000000G
000000000000S00000S0000TG0M000
00000000S000000000T00000000000
00S0T0000S0000000G00G000000000
