0000S00000000G000000000T00G0S0
00T0000S0000S000000000G0000000
000000000000G000GS000000000000
0000G0000000000000000S0T0G000S
00T0000000000000000000000S000G
0000000000000000T0000S00000000
000000T0000000S00S000000000000
0000000T000000000000000G000000
00000S000S0000C000000000G0C00T
00GG0H0S00000H0000S0000000H000
SS00000000TC000000000000000000
00000T00000000000S0000000000G0
000000SG0000G00000000000H00000
000G0T000000000G00S000000000H0
0S0G00000000000G00000S00000000
0000000000000000T0000000000000
000000G00000000000000000G00000
0000000S00G000000GS000000T0000
00000G000S0000SC000000000G000H
000000000GS0S00C0000G000C0000H
00000S000000000T0S00000C000000
000000G0S0000000000T000G000H00
000000G0T0S00000000000S0000000
T0G0000000000000S000G000000000
00000000000000000T000000000000
00000000000000S000GGH00000000S
0G0000T00000000000000000S00G00
00G00000G00000000000000000000S
G00000S0000T000000000000000000
000000000000000000000000000000
