000000000000000GGS0000T00BS000
000000GTG000000S0000000000000S
S000G00000S00T00000000M0000000
000000TS0000000000000000000G00
00T0S0000S00G0G0000B0000000000
000000000000S0000000000T000000
T0000S0000S00G000000G000B000M0
G000G000000S0000S000000000B00T
0S000000000000S0G00M00G000000M
0000G0000S00T00000000000000000
000000000000T000000000G0000000
0000G000000S0000000000S000T000
0000G000000S0000000TS0M0000000
T00000000000000000000000000000
000G000000S00000000000000000T0
000000S000000000000000S0000GT0
T00000S000000G0000000000000000
0000000000000S0T0S00G000G00000
G00S000G00000000000B0000S00000
000S00000T0S000000000000000000
000000GG000000000000000B0000T0
S000T000G0000000G0000S00000B00
0000000T0000000000000000000000
0000000000T0000000000000000000
0000000000GS0S000000000M000000
000S00G0GB000000000S00M0000000
0000G0000000000000000G0000B000
00000T00000000S0000000000000G0
0000G00000G0000000000SB0000000
000S00000000000000000000T000S0
