0T000000000000G00000
00T0000000000S0G0000
000000000G00000T0000
00000000000000G00T0S
0G0000TS0G0000000000
00G00T0000G00000S000
0000T0000S0000000000
S000S0000000T0000000
000G0000000000000ST0
000T000G000G0000000S
000000000000T000S000
G0000G000STS00000000
0000000000TG0S000000
00T00SGS00000000000G
00S0000S0G000000G000
S0S0000000000000T0G0
00S0000G00T000000000
000GS0T00G000000000S
00SS00T0000000000000
000GS00000000T000000
