00000000000000000000
0SS00G00G00000000000
0000000SS0000000G0T0
00000S00000000000G00
0G0000S00S000T0000G0
0T0000000G0GS0000S00
000000T0000000S000S0
00T0000S00000000S000
00T00SS00G0000000000
00000000G00GT0000000
000T0GS000S000000000
000S00000S00000000TG
000SG0T0G00000000S00
0S00000000S000000G00
0T0000000S000SG00000
00000000G0S0000000T0
00000000000000000G00
00G0T000000000000000
T000000000G000000000
00S00000T000000G0000
