0000000000000S000000S0g0000000
00t00000g00S00000000000g00SM0B
0000000000S000t0000000000000S0
g00000000t000000000S000g0S0000
000000000000t0000000000000000S
000000000000S000000000000000t0
00000g00Sgt0000S000000000000B0
0000000t000g00SgB000B00000S000
0000000000000S000g00000000t000
000000000000g00000000000000t00
0000000t0000S0g00S000000000000
00t000S00000000000000000000gg0
00S0S0g0000g00000M000000000t00
000000000000gt0000000000S00000
000000000000S00000g000000000t0
00000S000S00000000M0000000g00g
000000000000t000000g00000000g0
000000000000gS0000000000gS00t0
00000000g0g0000000000B000000B0
000000000000S0000000000000S000
000000000000000000000000000000
00g0000S000S0000000g00M00M0000
tS000g00000gB0000000000000000S
0000S0000000000000000000000000
000000000g000000000000000000t0
S0S0000000000MMt0000000000000M
00000000000000S000000000000000
00000000000ggB00000000S0000000
000g0000000S000000Sg0t0000000M
000g0t000000000000000000000000
