00000000000G0000000G00000S00T0
00000000000000000000000T000S00
000000G00TG0000B000000000000B0
00SS0000000T00000G000G00000000
S0S000000000000000M00000000000
000000000000000GT000S00G000000
0000000G000000000S00S000000000
T00S0000000S000000000000G00000
S0000000000000000000T000000000
000000S0000S00000000000000G0G0
T0000000000000000000SG00000000
000000000000000G00000G0000000T
T00000000000000S000000S0000000
000000000000G00000000000S00000
000SST00000000G000000GM0000000
S0000000000GG000T0000000000000
000000S0000G000S00000000000T00
0000000GS00000G000B00T00000000
000T000000S00000S0000000000000
0000000000000000TG000000G00000
00000S000000000000000000000000
0S00T000000000000000000G000000
00000000000000000000T000000000
00S0000S000000000MMM0000000000
G0000000000000TS00000000G00000
GS00000000GB0000000000B00SB000
0G000000000TS00000000G000000S0
G0S000000000000000000000000T00
0000000000000000000ST00G000000
000S00S0000T0000000000000M000G
