00000000G00S0T00000000S0000000
00G000000000000S00S00000000000
0000000000GS0T0000G00000000000
00000000S00T0000G0000000000000
0S000000000T00000000000GG00000
000G0G00000000000000000H000000
00T00000G000000000G00000H00000
00S00000000G0000000000000S0000
0000000000000G000TS0000S000000
G000000000T000000S00SGH0000000
0000000G0G00000T000H0000000000
0G0T00000000000000000000S00000
0G00G0000H000000000T000S000000
00G000S0000000G0000000H0000T00
0000G00G00T0000000000000000000
00000000000000G00T00000000000S
0000000000000000000000S0000000
0000000000000000T0000000000000
00GS000000000000G000T0000000S0
0000000000000T0000000000G00000
00000000S0000000000T00G0000000
0000T0000000000000000000S0G000
0000000000000000000G0000000000
0000000000000000GS0G00000T00S0
000000S000000T00000000000GS0G0
000GG00H000000000S00000T000000
00S00T0000000000S0C000000GG000
00000000T00000SS00000000000000
0GT00G00000S000S00000000000000
000000000000000000000T000G0000
