0T00S000S0G00G00000C0C00000000
000000S0S0000G0000000000000000
000000000000000S00000000S00000
000000000T00000000000000000000
000000000G00000000000000G00000
000S000000000S000000000000G0G0
00T00G000000000000000000000000
000000000GTG000000S000000H00H0
S0000000000000000T00SC00000000
T0000000G0S00000000000000S0000
T000000000000000000G000000000G
000000000G00T0000000S00000S000
0000000000000000000000000000S0
0000000000000T000000000G00000G
000G000000000000T0000000000000
00000T0GSG000000000000S0H000H0
0000000000000T000000000000000S
0000G000G0SH0T0000000000000000
000000000000000000000000000000
00000G00S00000000000S000000000
00S0000T000S000000000000000000
G00G00000000S0S0000T00000000H0
00SST000000000000C0GC00000000C
0000000G0000G00000T0000S00S0C0
000000000000000G0SS00000G00000
0000T00000000000000000000000G0
T00000S000000000G0000000G00000
0000000SG0000000000000000000G0
G00SG000000000000000S00H00000H
000S000GT000000000000000000000
