S000000000000000T000
0000T000000000S00000
0000000000S000T000S0
0000000T000S00000000
00000S0000000G00000S
00000000000000000SG0
S0000000000T000S000G
0000G0000000000G0000
000S0000S00000000CGT
0000000ST0000S00000G
0000000000000T000000
00G00S000T00000000S0
00000S00000000000T00
000T00000000000S0000
00G0T0G000000000S000
T000G0S000G0000000S0
0S00000T000000000000
T00000000000S00G0000
00GGS00T00000000000S
G00000000000SG000000
