000t0000000000000Sg00000000000
0000000000g0t000000S0000000000
0S0t0g00S000g000000000000B0000
0000000000000000S0000000000000
S00000000000000000000000tS0000
000t00g00g000000B000000B000000
00000St00000S000000g0000000g0B
0000S000g00000000000S0g000000M
00000S00000t0000000000000g0000
0000000000000000000000t00000g0
000S0000S00000g0g00000M0000000
0t000000g0S0000000000000000000
gt0S0000000000000000g000000000
000000000000000000000t000g0000
000000000000tg00000000000S0000
g000000S00000000000g00000t0000
000000000000000000000S00000000
0000000000tS0000000000000000g0
0000000t00000000000S0000000g0g
0000t0000g00000000g0000000B000
0000g0S00000S00g0BB00t00B00000
0000000S00tg0gB00000S000M00BB0
000000g000000000000000t00gS000
000t00S0S0M0000000000000M00M00
g00000g00t000000000000000BS00B
00000t000000S00g00000000000S00
0000000000000000S000000000g000
t0000000000000000000g000000000
00g0t00000g0000000000000000000
0000000000000000S0000000000000
