000000000SS0000G00000000000000
S000000000G000G00000ST00000C00
000000T00000000000000000000000
T000000000000000000S00000G0000
00000000000000000000G00S000000
S00000000T00000000000000000000
00000000000000000S0GT00SC0G000
0000000G0000000000T00G0000S000
0000T000000G00000000G000000000
0000T0000G00000000000000000000
00S0000000S000GT0C000000G00000
00G000000000T00S00S0GH00000000
00G000000000000000GH00000000S0
00T0000000000S000000000S000000
0000000000S0000000000T0000S000
00000G00000T000S00000000000000
0TS000000000000000S00000G00000
000000G000000000000T0000000000
G00000000000000000000000000ST0
0T00000SG00G000000000000000000
0G00000000000000T0000000000000
00G000000G000000000000000ST000
0000S000000TG00000000000000000
000000GS0T000S0000000000000000
000000000000T00G0000000S000000
00000T000000G0GH0000000000S000
000000000T00000000000000000000
0G00000000000S0T0000S0000000G0
T0000000SGS0000000000000000G00
00S0000TS000C00000000000000000
