00000S0000G000T00000
00S0S00GG00C00000000
0000000000000000000G
00000000000T00000000
T0G0G000000000000S00
0T0000000000000000S0
000000G00T0000000000
000S0000G0G0000S0000
0SGT00000S000C000000
00G000T0000000000000
0000S0S00C000000G000
00000T000000000G0G00
00000GT00000000G0000
000000S0G0000000ST00
00000000000000SGSG00
S000000T000000000000
000G00S00000TG000S00
00T0000G00000G0S0000
S0000000S0000T0000GC
0SS00000000000000000
