000000S0T0000000000SC0G0000G00
00T00000000S000000000000000000
T0000S0000000000G0000000000000
00000000000G0000S0T00000000G00
00000000000GS00000000000000S00
0S0000GG0000T00000S0H000000000
0000000000000T00000000S00G0000
0000000SG000S0C0000000T0000000
000T00000G000000000S0000000000
GG0000000000000T0000000000S000
GG00000H000000000000000000S00T
0000000S0000S0T000000000000000
0000T0S000G00000S0C00000000G00
00S00000000ST000000000000000C0
0000000000G0000G00000000000S00
T00000000000000G00000000000000
0000S0000000000000S00C00000000
0T0000000000000S000G0000000000
000000GS000G0000000H00ST000000
0000000T00000000000G0000000000
T0S0GS0000000000000000C0000000
0000000S00000000000000000000G0
T00000000S0000000000000000000S
0T00G00000000000S0000000000000
00T0S000S000000000000000000000
00S0000000G00SG0C0000000000000
00000000G00000T0000000SG00000S
000000S00000000000000SG00C0000
00G0000G000000000HS00000000000
000000T00000G000000000S0000000
