S00000000000000000000G0000000G
0000000T00000000S00000G0000000
00000T0000000000G000000SSG0000
0GG00H0000000H00000000000H0000
G00000000000000000000000000000
000000000000000G00S000SC000000
0000000000000000000S0000STCG00
00000000000000000G000000000000
0000000S00000G0000000000000000
000000000000000000000000000G00
00S00000000000G0S000C00C0000T0
000000G00G0SH000S00000H00T0000
000000S0G000000000000000000000
000000S0T000G00000S00000C00000
0T00G00000000000SSC00C00000000
00S000000000000000000GG0S0000H
0000000000000000G000000000000G
S0000000000G0000000000000000G0
0T00G000000S0000000000S0000000
000000000000G0000000000000S000
000000000GS000000000S0C000T0G0
T0000000000GG00000SHH00000S00C
0T000000G000000000000000000000
00S000T0S00000000000000000C000
000000000S000S000C00G00T000000
S00000000000T000G00000S0000000
0000000S00000GS000000C00T00000
0000G0000000000000000000000000
000000G000000G00H0S0000S000000
0000S00000000000T0000GG0000000
