000000000000000GT0000000000S00
00000TS00G00000S000000G000000H
SS0000G0G00H000000T0C000000000
000T00000000000G00000000000000
000000000000000000000T00000000
GG0S00000000H0T00000000000S000
G00000000000000T00000000000000
0G00000000000000G0000000000000
00G0S0GS000000000000C0H0000000
0000GG000000000000000000S00TH0
00000000G0T0000000000000000S00
0SS0000000000G00000000000T000G
T00000000000000S0G000G00000000
00000000000G00T000000000000G00
00000ST000000000000S00000G0000
0000000000000000000G000000000G
000G00000000S0G00000000T000H00
000S00T00000000000000000000000
0000000000GT000000000S00000G00
000000000S0S0000000000GT000000
0000000T000000000000000G000000
G00GT0H0S000000000000000000000
000G0SS0000000000C000000000000
00G0G000000000000000000TH000S0
00GS00000000000S0G000000000000
T0000000000000S000000000000000
000000000T00000000S00000000G00
0000S00T000000S0C0000000000000
0G0000000S00000000000T00G00000
T000000000000000000S0000000000
