000000000000T0000000G0G0000000
00000000T000000000000000000000
0000000GT00S000000000000000000
0000G000G0000B0000000000000000
00000G0S00000000000000000S0000
0000000000000000000000000T0000
0000000000G00000000000G000000T
000G0G0S00S000000000000000000M
0000000000T00000000G0000000000
000G000000T000000000000G0S0000
0S0000000000000T0000000G000000
0000G00S000S00G000000T00000000
00000000000G0000000SG00000S0T0
000T0000G000000000G000000B0000
0S0000000T0000000000S000000000
GGS0000T00S0000000000000000000
0000000000000000000S0000000000
00S00000000T00000000S0M0000000
00000000000000000G000T00000000
000000000S0000000000T000000000
0G0000000000G000000000000B0000
ST000000G00S000000000000000000
S00G0S0000000M00000000000000M0
T00000000000000000000000000000
00000000G0S000G000S0B000000B0M
0000T0000G00000000G0000000000S
000000000000000G000000G0000000
0S000000000ST0000000000M0000G0
T00000000S00SG0000000G00000000
0000000G000000000T000000000000
