00G0000000T0000000G00000000000
T0000000G000000GH0000000000000
00000ST0000000000S00000CG00000
0T0G00000000G00000000000S00000
000000S0000000000000000T0000G0
000T00S000000000000000S000000C
00GG00000000000S000TS000000000
0G000000S0T0G000S0000000C0H000
000S00S0000000G000G000000H0000
0S000000000T00000S000000G0000G
0000000000G000S000000000000000
00000000G0000000G0000000000000
0G000G0H000000000000S00000S000
000S0000000000000G0000000000T0
0000000T0000000000000000000000
000000000T0000000000000000G000
000000000G00000000000000G00T00
000T000G0000000000000000S00000
00000G000T000S0000000000000000
00000000TS00S0C000000G00000000
G00000000000000000S0000000000S
0G00S0G000000000T00H0000000000
000000000000000G000T00000000G0
0000000S0000T00000000000000G00
000S000000S00000000C00G0000000
S000000S00000T0C00000000000000
0000000000000000000ST000000000
00S000000000T000000000000GS000
0TS000000000000000000000000000
G00000T00000000000000000000000
