000000000G00TG000000
0000G00T0000S00000G0
000T0G000000G00000S0
0T000000000000G00000
00T0G0S0G00000000000
0S0000T000000S00G00C
0GTG0000000000000S00
00000000000000SG0000
0000000T000S0S0000C0
0T000S000000G0000000
S00T00000000G000000S
T00000000S00S0000000
00000000000GT000SG00
000000T0G00000S00000
000S0G0ST00C00000000
0000000ST0000G0S000G
0000000T000000000000
00000000000G0000000T
00T0000G000GS0000000
0G000000000000000000
