S00000000000000S000T0000000000
S000000S000C000000000000000000
0000000S000000T000000000000000
0G0000000S000000S0000000000000
000000S00S00000000000000000000
0000000000000SGG000T00000000SH
000S000000000T00000000000S0000
GT0000000000S00000000000000000
00000000000000T00SG0SG00000000
0000000TG00G0000000H00000S0000
0000000000000000SG00000000S000
00000S0000000000000GT0S00000C0
00G00000TG00000000000000000000
00000000S000000ST0G000G0000C00
G0G0S0000000T000000000000HS000
0000000000T0G00000000000GH0000
G00000000000000SS0000GC0000000
00G00000000000000000000S0G0000
00000G0000000S0SC00000T0000000
00T000000G0000G000000000000000
S0000S0T000000000000000G000C00
00T0S000S00000000000G0000000G0
0000000000G000G0S00000000000S0
00S00000TS00C0000000000000G000
ST0000000000G0000S000000000000
0000000000000000000000SG000000
000000000000000000000000000000
00GS0000000000G0S000000T0000H0
00S0G000G0000T00000S000000000H
000S000000T0000000000000000000
