000000000S00000000000S00000000
000000000000S0000000G000000000
0000T0000000000000000G00000S00
00GGT000000000000000000H000000
00000000000000000000G00S000000
0000G00S000T000000000000000000
S0000000000T00G000S00C00000G00
00000G00000000000000000S00000S
00000000000000000000S000000G00
00T00S000G000G0000000000000000
000S0000000T0G0G0H000000S00000
0000000000000S0G0000000000S000
G000G0T000000000H0000000000000
000000000000T00000000000000000
0G0000000000000000S0000000S0C0
T0000S000000G00000000000000000
0TG0000S00000000000S0G00000000
S00000000000000000000000000000
00G000000T00000000000000000000
SGS0000000C00000000000G0000000
000000T00000SS00000G0000000C00
00000G0G0000000H000000000T0000
0000000000T00000S0000000000000
0000S000TS0000000000000G000000
00000000000000T00S000000000S0G
00000000000000000000000000S00T
0T000000000000000000000000000G
0T0S0S000000C00000G00000000000
000GG0000000000000000000000000
0G000000T0000000000000000GH000
