000000000000000S00S0
0G000000000000000TS0
G00G000000000000T000
T000000G000000000S00
0000000SS00000000000
GT0000000000000S0000
0000000T0S0000000000
00000000T0S0000G0000
000000T000S00000S000
0G0000G0000000000000
0GS000000000000S0000
0T0000000000S00000GS
000000T000G000000000
0SS000000000T0000000
T000000S0G0000000000
0000000S0TG000000S0G
SS0G00G0000000000000
0S0G000000T000000000
0S000GT00000G000000S
0SS0000000000T000000
