000000S00000000000T0
S00T000000000S00GG00
G00000000G00000T0000
0000000S0G0S000000G0
000000GT00000G000000
00000000000S00000000
00000000000G000000S0
0000T000000S0G00G00S
000000000S00TS000000
00T00000G000G0000S00
G000000G000000000000
0SG0T00000G000000000
000ST0G0000000000S00
000000000T000000S000
000000000S00S0G00000
S00S00000000G0000G0T
00000000TS0S00000000
00T00000000000000000
0G0000000T000000000S
0000T000000000000G00
