000000S000000S0000000C00G0CG00
00S0000000000000000000G0000000
S0SG00000000000000000000C0G000
GG0T0000000000000H0000000000HS
0000000000000000T000G0000S00G0
000G00000000S000T000000GH00000
00000000000000SG0G000000000000
000000000000000000G00000000000
00S0GG000000000000000S00T0C000
0000000000000000000000000S00T0
000000G00000000000000000000000
0T0000G0G0000000S00H0S00000000
T000000000G0000000000000000000
0SG0G0T0000S00000000H0000H00C0
00000000000000G0T00SS000000000
00G00000S000000000000T0G000000
0GT0000000G0000000000000000000
00000G0000S00000000S0000000000
T00000000000000000000000000000
GS000000000T000000S00000000G00
00000000000000000S00000000000T
0T0000000S00000G00000000S00000
0G00000000G0000000S000S00000C0
T0000000000000000000000SS000C0
000000000000000000000000000000
0000000000S0000000000T00000000
00000GG0000000000000000S000000
00SG000000T0S00000000000000000
00000S0SC00000G00000000000000C
000000G0T000G00000000000000000
