00g0000t000g00S000000000000S00
000000tgS0000S000000000g000000
00t000S00000000g0000g00000000S
000000000000g000S0000t00000000
000S000S0000000M00000g00000000
00000000gg00000t00000000000000
00000000000000t000S00000000000
00000000000000000000t000000000
00000000000000g000000000000000
000g00t0000SS00000M00000000000
00000S000t0S000000000M00000000
0000000000g00000000000S0000t00
00g0000000000gB0000000t000S000
000000000000S00000000000000t00
00000000000000000000g000000000
000t0000S00000S000000g000000MM
00g00000S000000000000000000000
000S00000S00000M000000g0g0B000
000000000000St00000S00000000g0
00000S0000000t0000000000000000
t00000000000000000000000000000
0gS000000t000000000000SM000000
0S0t00000000000000000000000000
0Sg0000000000000t0000S00000000
000000000000000000t0S000000000
00gtg00000000000000000B0000000
S000S0000000t0g0000000g0000000
000000000000g00S0000t000000000
00000000S000000t00000000000000
00000000S000000000000000000000
