0000000000000T00000000000S0000
000GS0T000000000S0000000000000
G00000T00S000000000000S0000000
T00S00000000000000000000000000
000000S00T00000000000000000000
000000000S0000G000000000000T00
00000G00000S0000000G0S000000B0
000000000000TS0000000000000000
000000T000000000000GS000000G00
T000S0000000000G000000S00000M0
00000000T000000000000000000000
000000000000000000000000000000
000000000000000S00T00000000G00
S0S000T0000000000G0000000M0000
00000000T0G0000000000G0S000000
T00G00000000000000000G00000000
00GS0S000000000TG00M00B000BM00
00T0000000G00000000000000S0000
00000000S0G0000000000000000000
00000000000000000000000000000S
000GGB0000000S0S0B000000000000
S0000000G000TS0000000000000000
0S0SG0T000000000M0000000000000
000T00000G0000000S000000000S00
S0000000G00000000000000G000B0T
00000S00000000000000000S0M0000
000000000000G0000000000T000000
G0000000T000S000000000S000000M
0G0000000S000000000000000TG000
0000000000S000000000000000000G
