0000000000000000T00G000G00000S
00000G0G0000000TH00000000000S0
00G000000000000000000000000G00
000000000S0G0S000TC00000000G00
00G000000000G0H000000000000000
0000S0000000000000000000SC0G0T
000000G0000000ST0000000000S0G0
00000T0000S000000G00000000000S
0S0S00G000G00000000000000H0C00
00000000000G0000S000000000S0C0
0000G00000T000S0000000000G0S00
00000G000000T000G00000000000H0
000000G000000000000S0000000000
000000000000T0000000000000000S
000000G00000000G000000S00H0000
0000G00T0000000000000000S00000
0000000S000S000000000000000T00
00000SG00000T0000000000000G000
000S0000S0000CG000000000000TG0
0000000000000G000T0S0000000000
00000000T00000000S000000000000
0000000000000000000T0000000S00
0000000000000S00G0000000S0000C
000000G00T000000000G0S00000S00
0000000000G00000000000G00000S0
000G00000000S0S00000000T000C0G
000G00T0000GS0000000S00H000000
000T00000G0S00000000000S000000
S0000000000000T00000000000S000
0T000000000000000000000000000G
