00g000000S000000000000t0S000g0
00g00000S0000000t000000gB00000
0000gt000000000000S000000g0S00
g0000g0B00000B00000t0000000000
0000t0000000000000000000000000
t000000g0000SS000000000000g000
00S0000000S000000000000gg00MM0
0000S000000t000000000000000000
S00tg0000000000000000S00000000
00000g0000000g00000SS00t000000
00000S000t0000S000000000000000
t00000000000000000000000000000
000000000S00S0t000g00000000000
000g0S00000000000000S0000000g0
0g000SS0g0000t0000000000000000
000g0000000000S00S0000g0M0t000
g00000000000t0000000000000g000
0000000g000g0000000BBB0000BS00
000000000t00000000000000000000
0000000000000000000000000000g0
000000000000000000Sg0000000t00
000000gS0g00B00000000000S00000
000000g00000000gB00t0S00000B0B
0t0g000S0S00000000000g00000000
000000000000000t00000000000g00
00t000000000000000000000g00000
0t00000S000000g0S00g0BB0000000
00000000t00000S000S0M0M0000000
0S00000000g000000S0000t0000000
0000000g000000000000000000g000
