0g00t00S00000000000g0000000000
00000t000000000000000000000000
00000S00t0S0000000000000000000
0S0g00gt000000000000000S000000
000000t000000000g00000000S0gS0
0000S0000000000S000000tg0000M0
00000t000g000g0000B00B00000000
000g000g00000S000t000000B00000
S00t0000000S000000000000000000
000000000000000000000000000000
0000000S00000000tg0000000S000g
00gt00000000000000g0B000000000
0000S00000000t0000000000000000
0t00S0000000000g00000g00000S00
000000S0S000g00M000t0000000000
000S000000gS00000000000t000000
00000000000S0000000S0g0t000g00
0g0000000t0000000000S000000g00
00S00000000000t000000000000000
00000000000000S0t00000g0000000
00g0000000000000000t0000000000
000tS0000S00000g000000Mg0000B0
0000000000000S00000000000000S0
000000t000000000000000000S0000
00000t00000000000000000000S000
t0000000000000000S0g00S0000000
00000000St000000000000000g0000
t00g00000000g0000B00000S000000
0000000t0000000gg0000000000S00
0000000000000Sg0t00000000S0000
