00T000000S00000G00000000000G00
S000000G0000000000000000000000
GG00000000000T00000000S000S000
0SG0000000T00G0000000000S000B0
T00000000000000000SG0000000000
S000000T000000S0000000000000M0
0S000GTG00S0000000000MM0000000
G0G0000B0000S00000T00S00M00000
000S000G000000000G000000000000
000000000S000000S0G00000000000
000S0000TG0000000G0000000000B0
00000000000000000G00000G00T000
00000S0000S0000000000000000000
S00T0000000000000000G00000S000
000000000000000000000000000000
0000000T0000000000S00000000000
0000000000S0T000G0000000000000
00000000000000000000G0000GT000
T000S0000000000G0000G000000000
00T0000000000S0000000G00S00000
0000000000000000000000000000T0
000000T0000G000000000000000000
00TGG00S00S0000000000000000000
S000T0G000000000S000M000000000
00G00000000000T0S00000000000S0
0GG0000000T000S000000000S000BM
000000000G000000000000T000000G
000T0000G0S000000000S000G0B000
0000000000000000000000G0000S0G
00G0000000000T00G000000000000S
