0000S000000T000000000000000000
00T000000000000S000000000000G0
0T0000000000000S000000000GG000
000S000S0000M00T000000000000M0
0G000000T000000000000000000000
0000000000000000S00T00000000S0
00G00T00G000000000000000000000
000000T00S0000000000GS00000000
000000000000000000000000000000
T0000000000000000000000000G000
000GT0000G00000000S00000000000
00000S0T0G00000000000000000000
00GG00000BB0B00000T0000S000000
00000000T000000000G00000000000
000000T00000000000000000000000
000TG0000000S0000000000000000G
000000000000000000000000G00000
00G000S0000000000000T000G00000
00S0TG000000000000000000000000
000T000000000S0000000000000000
00000T000000000000000000000000
0000000000000000000000S00S0000
0000000S00S000000000M000MM0M00
000000000S0000000T000000000000
00000T000000000000000000000000
0000000000000000000000G000S000
0S00S0000000000000T00000G0M000
00000000000S0000000000000000G0
00000T00G000000G0000000S000000
0S00000T0000000000000000G00G0B
