00000000000000000T00
0000S000T0000000G000
S0T00000000000G0G000
00GS0G00000ST0000000
00000G0000G0T00000S0
00S00000000000000GG0
00000TS00000S0000000
0GT00S0000000000000G
0000S00GS00000000000
0S00T00S000G0000000G
00000S000000000G00S0
0T000000000S0000G000
G00000S0S0000000T000
G000000S000S00000000
000G00G0000000000S00
0000SS0GG00000000000
00000T0G000000000000
0000SS00000000000000
00S0T00S00000G000000
000000000T000S000S00
