GT000S0000000000G00S0000000000
0000T00000000S00000000000000G0
00000T00000000000000S00SG000GC
00S000000S000T0000C00000000G00
00000000000000000S00000000T000
00000000000000000T000G00000000
00000000000000000000000000000G
00S000000000G0S000000000000000
00000000S000S0CC000000C0000000
0000T000000GG0000000H000000000
00000S000S0T0C00000G000G000000
0000000T000000S000GS0000000000
000GS00000000G0000T00000000000
000000000000T0000G000000000000
00000S0SG0G000000T000000000000
0S000000T00000000000S000000000
0000000000000S000S000000T00000
000000S0S00T0000C00C000G000C00
00S00000G0S0T0G0H00H0000000000
00000G00T00000000000000000000S
0000G000000S0000G00000T000000H
00000S0S0000000000000000000000
00G00000T000000000000G00000000
G00000000S000SC0T000000000G000
S000000TG000G00000000000000000
00000000G00G000HS0000000000H0T
G000S00000000000000000000000G0
S000T00000000G0000000000000000
00000000000T0000GG0H0000000000
T0000000S000G00000S0G0000HCC00
