000S00000000S00000T00000000000
00S0T0000000000000000000000000
00000T000000000G00000000000GS0
00T000000000S0G000000G00000000
0T000000G0S00S0G00000000000000
000000T0000G000000000000000000
00000000T0000000000000000000S0
0T000000S00000000000000S000000
T00000G00000S0G000000000000000
000000000T0000000000G000000000
000000000S0SM0M000000000000000
00000G0G00B0000000SS00B000B000
00000000000000000000G000000000
0S0S00000000000000M000000M0000
0000000000000000000G000G00B000
0G0000T00S00000000G00000000000
G00GT00000000S0000000000S000B0
0T0000000G000S000S000000000000
000S00000000000000000000S00000
0S000SG0000000000000000000T000
0TG0000000000000000G000B00000B
00000000000000S000000000S00000
0000000000000G00T0000000000000
S00000S00M0000G000M00000M00000
0000000G000G0000000000B0T0BS00
T000000G0000000000000000000000
000000000T000S0000000000SG0000
00000000000G000000000000000G00
0000T000000S0000000000000000G0
00T00000G00S000000000000000000
