0000000S000000000S000000T00000
G0000T0000000000000000000000S0
000000000000000000000000000000
000000000S0T000000000000000000
0S00000G00S0000000000000000000
000T000S00000000000G0000000S00
000G000000S0000T0000000000000G
000000G0GH00000000000000T00000
0000000000G0000S00000000000000
00S0000000000S00G000000C000000
0S000000000000S0000T0000000000
000G0000000T000S00000000000000
0S0T00000000000000000000000000
0000T0000000000000000S00GS0000
00000000000000S00000G00000G00H
00G000000000000000S000000T0000
00000000T000000000000000000G00
00000G00000G0000000000H0000000
00000000000000S000000T00000G00
0T0000000000000000000000000000
0000000000000000000G000000000G
T000S0000G0000000000000G00H000
0000000000000S0000000000T00000
000000G0S0S000000000000000G000
000T000000000G000000S000000000
0000000TSSGG000000000000000000
0G0000T00G0000S00H000S00000000
00000S00S00G000C000G0000000000
00T00000000G000S000GS000000000
000GG000T00000000000S000H000S0
