0S000000000000000t000000000000
00000000000t00000000000000S000
000000g0Sg0B000000B000S000000t
0000000g000S0000g00000B00t000B
00000000S0000000t0000000000000
S000000000000000000g0000t00000
000tS000S0g0000000000000000000
00000g000S00000000000g0000t000
000000S0000000000000000g0000t0
00000gg0000t0B0000000000000S00
00g00000000000000g000B00000000
0000000000000000g0000000000000
00000St00S00000000000MM0000000
0000t000Sgg000000000S000M00000
0000SS00t0000000000g0M000M0000
t0000000S000S000000M0000000000
0S00t00S0M0g000M0000000000000g
00S0000000gS0M000M00g000000000
0000000000000tg000000000000000
0000000000000g000000S000g0SBt0
00000000g00000000000000000000S
0t00g000000S00000000S000g00000
000g00000S0t0000000000000000g0
00t00000g0000S0g0B000000000S00
0000000St000000SM0000000000000
0t0000g000000000000S0g00000000
0000000g00g0000000000000000000
0g00000000000S0g00000000000000
0g000000000000000t000000000000
gt000000000S0000000g0000000000
