TS0G000000000000000000000S00G0
0T0000S000G000000000G00H000000
0000000S0S00000000C000C000000G
0T0S000000SG00G0000C0000000000
0S000000G00000000G000000000000
0000000S0S000000000000000000G0
00G0000T00S00000G0H000000HSH00
0T0000000000000G0000000GH00H00
000000000S0000G00000T0000G00H0
000000000000T00000000000000000
0000000000000T000G0000000G0000
000T000000G00S0000000000000000
0000G0T0000000000000G0H0000000
000T000000000000000000S000000G
0S0G0000T000000000000000000000
0G0000S00000000000000000000000
G0000000SG000H000HSH00000T0000
0ST0000000S000000000000000000G
000000G00000S0000000000000T000
00000000000G000000000000G00000
0000S000000S0000G00000T0000000
00000G0000000000SGH00S00000000
000S000G0000000000000T0000S000
0GTG00000H000000000S0000000S00
000000T0000S00000S000000000000
00G0000S00000T0000000000G00000
00000000000000G00000000000G000
00S0S00000000G0000000000T0000C
000T0000000000000000000000S0S0
000G0T00G000000000000000000000
