00000SgSMt00000000000000000000
000000g0g00S0000000S00t0000000
000000000S00000S00000000g0M000
00000000S000000000000S000M0000
S00000S0000t00g0000000M0000000
000S00000g00000000g000000000B0
00S00S0000M00000000000g0000g00
000t00000000000gS0000S0g000000
g0t0000000000000000S0000g00000
00000000g000000000000000000S00
000t00000000000000000000000000
0g00t00000000000000000g0000000
00000000000000St00000S00000000
000000000000000000000000000000
0000000000000tg000000000000000
0000S0000000t0000000g000000000
00t000000000000000000000000000
000000S000S0000000MM0000000000
00S00S000g00000Mg0000t00000000
g0000t00000000000S00000000gS00
0000000000000g00000000000000t0
g00000000000000000000000000000
g0S0000000000g000S0M0000000000
000gt00000gS000000000000S00000
0000g00000S00t000S000000000000
0t00000000000000000S0000000000
000000000000S0000g0000t00S0000
000S00000000000000000000000000
t00000000000000000000000000000
000000S000000000S0000000000000
