000000000000000000000000000000
G000TG000S0H000000000000000000
000000T000000G0000000000000000
000000G0000S000000000T00000000
0S0G0G0000H000000000T0S0000000
00000S00T0000GG000000H00000000
0000000000S00000S0C0T0000000G0
T00000000000000S00000000000000
0G00000GST00S0000000000C000000
0S00S00T0000000GC0000000000000
S000000T000000000SG00000000000
S00000000000000000000G000G0S00
0S00S0000T000C0000000000000000
000000000000000T00000000000000
00000000G000000G00H000S000T000
000S00S00000000G0000000G000000
0000000000000G000G000000000T00
0T00000000G00000000000000S00G0
0S0G0000000000T0S00G0000000000
000000000000000S000T0000000000
0000T000000000000000000G000000
0000000GTG000000S000H0S0000000
0000000S00000000S00000000C0G00
0S0T00S00000000000000G00000000
0000000000000S0000000000000000
GS0000000000S00000CG00000000H0
00000000T000000GG0000000000000
00000000T000000000000S00G00000
00000T000000G00000000000000000
0T000000000000G00000000000S00G
