0000000G0000S0000000S00000000G
T000000000000S00000000000S00G0
G0000S00T000000000000000000000
T00G0000000000S000000000000000
000000G000000G00000S00000000ST
00000000000000000000000000S000
0000000T0G000000S0000000000S00
0000G000000S000000T00000000000
00000S0000000G0000000000000000
000000T00000000000000S00000000
0G00ST0000000000000000S00C0000
000000000S00T000S0000000000000
00T000000000000S000000000S0000
000000S00SGG0C00000C0000000000
0000000T0000G0S0000G00000H00H0
00000000000000000TG00000S00S00
G00S000000000S0000GT00C0000000
000000GS00G00H00000S000000CTC0
00000000G000000000000S000G0000
000TS0S0G0G0000000000000000C0H
000000GT0000000000000000000000
0G00T000000000000000G000000000
TS0000000S00000000000000C0C000
0000000G00000G0000H0000000000H
0000T00S0000000000000000000000
0T000000000000S0000000000G00S0
T00000000S00000000000000000000
00T00GG000000S00000000000S0000
0000000S0G0G000000000000000000
0G0000000000000000000000000000
