00000000GS00000000000S00000000
00T00000000S0000000000000G0000
000T000G0000GS000000000H000000
000000000000000000000000S00000
00000T00000000000G000S0S00000C
00S000G00T000000000000000G0000
T0000S0G0000G0000000000000H000
00T000000000S0000000000000000G
000000000000S00000000T00000000
00000000S000000000T00000000000
00TG0000G000000000H0S00S0H0000
G000S00000000000000000T0G00S00
000T0000000000G00000G0000000H0
G0000000000000GT00000000000H00
000000000000000000T0000S000000
0T00000SS00C00000000G000000000
0000S000000000000000000000000G
000000SS000000G0G000H000000000
0000000TS000000000000000000000
000000T00S00000000000000000000
0T0000000000000000000G00000S00
00000000000S0000000000000000T0
000T000000000000G0000000000000
0S0000S00000000000C00000000000
G000000000000S00000000000T000S
00000000000000000G0000S00G0000
0000S000000000G0000S00C0000GT0
T0000G000000S000000000000S0000
00000000T000000S000G0000000000
000000000G000S0000000000000000
