T000000000000000000000S0000000
0000000T00S00000000000000000S0
000000000000000000000000G0000S
0ST00000S00000000M000000000000
00000000ST00000000000000000000
000G00000000000S000T000000G000
T00S00000000000000000000S00000
000000000S000000000000T0000000
S0S000000G0000000M0000G0000000
000000G00000000000000000000000
000000G000000000000T0000000000
S000G0000T000000000000000G0000
000000T00000000000000000000000
G0000T000000000000G0B000000000
0000S000000G000000G00000S0000B
000000000000000SS0000000000000
00000000000TG0000000000G00S000
0TG000000S0000000000000000G000
00T0000S000000S00000000G000000
0000000S00000000T000000000000S
0S000T000G00G00S00000000B000M0
0000000T000000000000000S000000
000000000000000000000G00000000
00S00T00000S0000000M0M00000000
G00000000000000000S0T000000000
00S00S0G0000G0000000B000000T00
0000000000000S000TS000000M0000
0000000000G0000S00000000000000
0000T0G000000000000000000S000G
00S0000000000000T0000S00G0000M
