0000000S00000000000000000000G0
000000T0000000000G000000000000
000000000S000G0000000G0T0H0000
00000S000000GT000S0000000G0000
0000S0TS0C00000000000000000000
0000000000S000000000000G00000T
000G0000000000000000000000000G
SG000000000T00000000G00H000000
0000T00000000G00000000000S0000
G0000T000SS00G0000000000000000
000S00000000000G0000T00S000000
000G0000000000000S000000000000
00S000000000T0000000G0S0000000
T00000000000S00S0000G0G0H00C00
T0000000000G000000000000000000
0000000000T0G00000000000000S00
000S000000S00GT000C000000G0000
000G0000S00100000T000000000000
G000000000000T0000000000000000
0000000000000G000T000000000000
00000T0000S0S000000C0000000000
0G00000000S00000G00H000000000T
00000S00T000G00000000000000000
00000000S000G0T0000000G0000000
000S00000000000000000000T000G0
00000000000G0000S0000000000000
0T000000000000G00000GS000000H0
00000G0000000000S00S000000G000
00000000000000000000000T000000
T00000G00000000000000000S00000
