00T0000G0000000000000000000000
00000S0S0C000000000000T0000000
S000000000T000000000000000000S
00000G0000G00000S000S00C00000T
000T00S0S000000000000000000G00
00TS0000000S0000C0000000000G00
00000G000000000G00000T00000000
00000000000S000000000000000000
ST0000G00000000000000000000S00
00000000000000000S000000T00000
000000000000000000000000S00000
0S0G000000000000000000000000T0
00G0000G00000S000S0000H0000000
0000000SG00000000T000000000000
0S0000T0G000000SG0000000000000
0000T0S0000000S000000000000000
0000G000S0S00000000000000000C0
000GS000000000S000000000000000
T00G00000000000000000000000S00
00000GS00G000000000H0S00000000
000000000000000000000000000000
000TG00000000G000000H000000000
T000000G00000G000000H000000000
00S000S00C00000000000GTG000000
0000000G000000000G0H0000000000
0G000S000000S0000G00T00H000000
000000000G0000000000T000000000
0000T0000000000000000000G00SG0
000T0G0000G000000000S000000HS0
0000000000G0000000000S00000S00
