0000000000000S0000S000T000000M
00000000000S0S0T0000G000000000
0G000000000000G000000000000000
00S0000000000000S0G0000000M0G0
0T000GG000000000000SB000000000
T00000G00000000000G000S00BB00B
0GS0000000000000000000S0T0000G
000000S000000G000SM000G0000000
0000000S0000000000000000000000
000000000000000000S000000T0000
000000000000000000000T00000000
0000G000TSS000000GB0M00000M000
000000TS000S00000M0G0000000000
00000000000000000T00S000000000
0000GT000S00000000000000000000
000000T0000S000000000000000000
00T000000000000SG0S00000000000
00T00000000G00000G0000B0000000
000000000T00000000000000000000
0000G0000G000000000000B0000000
00000000G00G0000000000B0000000
0000000SS000M00T000M000G000000
00000000000000000S0000000S0000
00G00S000000SM00T00000G0000000
0000T00000000000G0000000000000
000S00000000S00G0M000000G00000
000000G0000000000000000000S000
00000G0000G000B0000000B000000S
0000000000000G0S000000G0000000
0G0000T00000000000000000000000
