0GT00000000000000000
00000TS0G0000000S00G
0G0000T0000000000000
0000S000GS0TG0000000
000T0000000GS00000G0
00T0000GS000G0000000
0GGT0000000000S00000
0G00000000T00G000S00
0T00G0000000000S0000
00T00000G0G000000000
0T000000G00G00000000
0SG000000S00000000G0
T000000000000S0000S0
00T0000000G000S000G0
00GT00000G0000000000
T0G000000000000S0000
T0000000000000000G00
000G00G0T00000000000
0T00G000000000G00000
SG00T000000000000S00
