00000T00G00S0S00C000
00GG0000000000000000
000000G0000000000000
00000000S000T0000000
0000S000G00S00C00000
00000000000000000000
000G000ST0S00C000000
0S0S000000C000T00000
0T0G0000000000000000
00T00000G00000000000
00T0000000G0G0000000
T0GG0000000000000000
0S00T0G00000000S00C0
00T00G0000000S000000
T0000G00000000000000
000T0000000S00000000
0T000S00000000000000
000000000GSS00000000
0G0000000T000000G000
000T0S0S000C000000G0
