0000000000000000000000S00000T0
000000000000000000000000S00000
0000000T00S00S00000000000G0000
000000G00000000S00T00S00000000
0000S000000000000000G0G0000000
G00000S00000T000000000S0000000
0000000000T0000000000000000000
0000SG0000T0000000000000000000
000000S0GT0SG000000000C0000000
00000000000000S00000000000000T
00000000000T0000000G0000000000
00S00000TSC0000000000000000000
00000000000000T00000S00S000CG0
0000000000000000000000T0000000
0000000000000T00000000000S0000
S000000GT000000000000S00000000
00000000000G00000000000G000000
G000000000000000000000000T0000
000S00S00G00000000000000000000
00000000000000000T00000000S000
0T0000000000000000000G00000S00
GT000000000000S000000000000000
0000T0G000000000GS000000H00000
0S0000000000000000000000000000
00000000G000000000000G0T000H00
000000T000000000S00G0000000000
0000000000000000000T000SS00000
T0GS00G00H00000000000S00000000
000G00S000000000000000000S0000
000000000000S00G000000S0000000
