00000G0T00S0000000S0000C0CG00H
0000G00S0000000000000000000000
0000S0S00000T000000C0000C00000
T0000000S0000000S0000000000000
00000000T0G0000000000000000000
000000000T00000000G0000000000S
00000S000000T00G00G000S000000C
00G00000000000G000000H0H0000H0
0G0000000000G00000T0000000000H
0000TS0000S00000000000000G0000
00SS000000000000C0000000T00000
000000000000000000000000000000
0000000000000000T0000000000000
0T000S0000000000000000000000S0
000000000000000000000000000000
0G0000000G00S000S0000000000000
00000000T0000000000S0000000000
0000T0000G00G0000000H000000H00
000000000000000G000000000000SG
000000S0G000000000000G00000000
000000T0000000000000000G000S00
0000000000000000G00000G0000000
00S0T0S000C0000000000000000G00
0000000000G00G0000000000000000
000S0SGG00T0000C00000000000000
0000S00000000000000T00SG00000G
000000S00000000000T00000000000
0T00000000000000000000000GS000
0G0000T0000S000000000000000000
000TS000000000000G000000000000
