000000g0000000SSM00M00t00M0000
0t0000000000S00000S00000g00M00
00000g0000000S0000000S00000t00
0000000000000000000000000S0000
000000t0000000000S00000g0000S0
0000000000S0S00000000t00000000
0g000000000000000S00000000g000
00000000000000S000t00000000000
000000000t0000000000000g000000
00000000S00gS00000g00000000000
0000000t0000000000S0000S000000
00t00000000000000g000000000000
000t00g00g000B0000000000000000
00t0000000000S0000000000000000
0t000S0000000g000000000000g000
000g000000000000000000t00g0000
00gS00000000000000000t00S00g00
g0000000000000000g000000000000
000t00000S00000000000S00000000
0g0000S00000000000t00000000000
t00000000000000g0000000S000000
000000000000000000S00000S00000
000000S0t0000000g0000S0000M000
0g000000000000000S000000000000
000S000000000000000g0000g0S00B
000S000000S00t0000000000000000
0000000g0SS0t0000000g00000000B
000g0g0t00000000000S0000S00000
0000000000t0000000000000000g00
0g000000000000000S00000000000t
