00000S0ST0000G000000
0000S0TG0S00C0000000
T00S00SC00G000G00000
000TS0G000G0S00000C0
00000T00000S000S0000
000000S0000S00000000
T00G0000000S0G000000
000G0S0000000000S0G0
0000ST00000000000S00
000G00000000S00T0000
S000000T000S0000000G
S000000000000G0G0000
0000G00000000000T000
SGS0000000G00000CT00
0TSG00G0000000000000
00000000000000000000
0000T000000000000000
0G0000000T0G00000000
S0000S000GC000000000
S00000000S000000000G
