000000G000000S00000S000C0G0000
000G000000000G000000T000000000
00000T00G000000000GS0000000000
0T0S00000000000000000000000000
00000000000000000T00000S000000
0000ST0000000000000000S0000000
0000S0000000000000000000ST0000
0000000G000000T000000S00000000
0000000000000000000G00GH000T00
S00000000000000000000000000000
000000000000T0000000G0000S00G0
T000000000G00000000G000000S000
0000T0000000S00G0000000S000C00
000G00T00S0000000000000000000G
0000000000000000000000000000T0
0T000000000000000000000000S000
0000G000G000000H00000000000000
T0000000000000000000G000000000
00G000T0GH00000000000000000000
00000000S00000000000GS0T00000C
00000S000T0000000S0000000000G0
S000000000T0000000GS0000000000
00000000000000S0000000ST000000
00T0000000000000000000G0000000
0S0000000S00G000000000000GT00C
00000G0T0000000G000S00000H0000
000000000000G0S00G000000000000
000T0G00000000S00G00000S00C000
000000000000000S00000000000000
0000000G0000000S0000GTS0000000
