G00S0G000000000000T0
00000000000S0000G00G
00000T000000000000S0
S00T0000000S0000C000
00G00G00000000000000
0000GS0000000S000000
S0T0SG000000000G0000
00S00000000000000000
000000000000ST000000
000T0000000000000000
0G0000000G00T0000000
0000000SS0G0C0G00000
000T0000G0S00S000000
00000000S000G0000000
0G00000000ST00000S00
0GSS00000000000000C0
GT000000000000000G0S
0G0000000G0T00000000
0000000T0000000000S0
000000000G00T0000000
