0000G000000000000T00000000S00S
00S000T0000000S000000000000000
000000000000000000G0000T000000
ST00000000S0G0C0000000000000G0
00000S000000SG00G00HC0000T0000
0000T000GG000000000H0000000000
0000000000T0000000000000000000
000000000000000000000000000000
S0000S0G0000000000T000000G0000
00GT00000000S000000000S000000G
00000S0000S00T0000000000000000
000T00000000000000000000000000
000TGS00000000000S00000C000000
00000000T0G0000S00000000000000
0TS0000000G000S0G00C0000H00000
G000000000000000000000S000G000
00G000T0S000000000000GH0S00000
000000000T0000000000000000S000
G0000000000000000000TS00000000
000G00000000000000T000000000S0
0T00000000000000G000000S000000
0000000G000000000000000T000S00
000S0000000000S0000C0000000000
G0S00T000000000000000000000000
000000000000000T00000000000000
00000000000S000000G0S0G0000000
0GS0GT0000000000000S000000000H
000000000000000000000000000000
T0000000S00000G00000000S000000
00000000G0000000000000G00HT000
