000S0000S00000000g000000M0g000
00000S000000S000t0g00000000000
t0S00000000000000000g000000000
00000000000000t000000S00000000
000000000g000gS0000000B0000000
00g00St0000g00000B0B00000B0000
000g00000000000000000g00000000
00000t000000000000g0S0S0000000
00t00000000000000000000000000S
00t00000000000000000g000000000
0000000000S0t00000000000000000
000000000000000000tg0S0000g000
00S00g000000gB00000000S0000000
0000ggBt0000000000000S00000000
t000000000g0000000000000000S00
0000000000g0000000000S00000000
00000000gt00000g00S00000000000
0000000000t000000000000S000000
0000g00000S000S000000000000M00
S0000g0S0000000000g0000BB00000
0000000t00000S0g00000S00M0M000
0S000000000000S0g0000000000000
00000000000000000000000000000S
00000t00000000000g000000000g0B
0000000000000S0000000000000000
000000S00gS0000M00000000000M00
g000g0000000S000000000B0000000
0000g00g00S000t00000000B000000
000t0000000S00000000000000000g
000000000000000000000000000000
