00G0000SS000000T0C00
00000S00T0000000G000
S00G0000000000000000
000G000000TG0S000000
00000G0000S000000SC0
G00SG00S000C00000000
0000000000000000S000
T0000000G0000G000000
0000GT000000S000SCG0
00000G00T0000S0000S0
00G0S0000000G0000T00
000000000S0000TS00C0
000000S0000000000000
T000SG00000000000S00
00000000G0000T000000
T000000G00000000000G
000S0S000C0000000000
00G000G0T00000000000
00S000000T0000000000
000T0000000000000000
