0000000000000000G00TS000000000
S0000S00M000000000000000000000
0G00TG0S00S0B000000BB000000000
00000000S000000G0000GB0000000S
0S0S00MT0M000000G0G000000000M0
00000S0000000T0000000000000000
0S00000G000000000G000000000T00
0T00G000G0000000S0000000S00000
T0000000000G00000000000000000G
0000000000G00000000000000ST000
0S0000000000S000000000M0G00000
000000000000S0000000000S0G0M00
G00G00000000T0S000000000000000
T000000000G000000000G000000000
000S00G00000000000T000000000G0
0GT00S0000000000000S0000000M00
0T00000000000000000000000S0S00
G000000S0T0000G00000000000000S
0000000000000S00000G000000G000
0T0000000S00000S00000000000000
000S0T000SM00G000000G000000000
000000000000000000000000000000
G000000000000G000000000T00B000
00000000S0000G000000STM000G000
000000000S00TS0000000000000000
000G000000GS000000000000B00000
000000000000000000000000000G00
0S00000000000000G0G000000000B0
0S00G0000000000000000G0000000B
000GS00000G0T0S000000000000000
