0000000GG000000T0000
00T0GG0000000000SS00
00T00000000000G00000
00G00000000S00S00000
0T00S00000S000000000
000T0S00000000000000
G000000T000000000000
00S000000000000000T0
000000000G000000000G
0G000000000S00000000
0000000G0000000T00SS
S00T0S0G0000G0000000
0S000000S00T00000000
0000T000000000000000
0000000000000S00000T
0G000000000S00000G00
T000GG000000000S00S0
00000000G0S00000T000
00000G000T0000000000
000T0000000000000000
