00T000000G0000000000
S000S0000000000000T0
S0000G00000S00000000
000000000G00000S0000
GSS000T000000000G000
0000G00S000S0CG00000
0000S000T00000000000
G000S000S000000GT0C0
T0000000000000SS0000
T00000000G000000000G
S0000S00000CG000G000
000000S000000000000G
T00S00S000G000000000
T0G00S000S0000000000
0G0S000000G000000000
T000000000000S000000
0T0G0000000000000000
000T0G0S000000000000
00G000000G00000T0000
0G00000T00000S0SG00C
