0G00T0000000000000000G00000000
00000000S00T000000000000000000
000T00000G000000000G0000000000
T000SG000000G000000000H0000000
000000T00000S00000000G0000S00G
00000000000S00000S00000T000000
T000000S00000000000G0000000000
0000000000T00000000000G0G000H0
000000000000000T000G0000000000
0S00000000000000000T0000S00000
000000000000T00000000000000000
0000G0000T000G0000000000000000
0G00T000000G000000000000000000
0S000000000000000000000000G000
GT0G0000000S000000000000000H00
G0000000G0000000S0000000000000
000000S00000000000000000000000
0000000000000000ST00000G000000
000000ST0000000G00000000000000
0G0000GT0000000000000H00000000
G00000000000000G0000S000000000
G0S000000T000000000G000000000H
00T0000G00S0000G000000000000S0
0000000000000000000000000G000T
000000G00G0000000000S00000H00T
000000000T0000000000000000S000
S00G0G0S000000T00000000000H000
00000000000G0000000000S0000000
00T0000000000000S0000000000000
0GT00000S000000000000000G00000
