0000000G00T00000000000S00S0000
000T0G00000000000G000000000000
0TS000000000000000000000000000
0000S0GG00000S0000000000000000
0G00000T00G0000000000000000S00
0G0000000S00000000000T00000000
00T0000000000000000000G0000SG0
0T0000000000000000000000000000
000S0000000G000000000000000000
000000T00000S00000000000SCG000
00SS00G0000T00C000CG00000000H0
000T00000000S000G00S0000000000
0000000000000000000000T0000000
0000000000000S0000000000000000
0S00000000000000000S0000000000
00T00S000000000000000000S00000
0S0000T00G000G0H000000S00000C0
000000000S0000T00000000G000000
0000000G00000G0SS0000000H00000
00SG00000S0000G000000C00000000
0000000000000000S00G0000000000
00G0000000T00000000G00000SSH00
S0GSG0000H00000000000000H000CC
000000000000TS00000000S0C00G00
000000T00S00000000S0G00000000C
000000000G0000GT0S00S000000000
000TS00000000000000000000000G0
000S000000T000000S000000000000
0000000S0000000000T000SG000000
000000S00000T00000000000000000
