0000S000000000000T0000S0000000
T000G00000000000G000H0000000HH
000000000000000000G00000T00000
00G00TG00000H00000000000000000
0G0G000S000000TH0H000000000S00
00000000SG0000000000000G000000
0000000T00000000000000000000G0
000G00000000000000000000000000
S0T000000000000000S000GCG00000
000G00G000T000000000S000HH000H
0T0000000000000S000SC000000G00
00T000000000S00000S00000G0G000
000SS00000000T000C000C00000000
0G0000T00000S00000000000000000
0G00T000000000000G0H000H000000
000ST00000S0G00000000000000000
0000000T0000000000000000000000
0000000000000000000S000T000000
0T000000000000G00000000000G00S
S00S0000000000000G0000000G0000
00000000000T000000000000000000
0G0000000S0000G00T000000000000
000000000000000000000000000000
00T000000G00000S00000000000000
000SG0000G0S000000000T0000H00H
0T000000000S000000000000000000
T0000000000000000000000000000G
00000T000G0000S00000S000000000
000T000G000S00000000G0000000S0
000000S00T0000000G000S000000C0
