0000000T00000000000000S0000000
T0000000000G00000000S000000000
0000000000000000T0000000S00S0C
0000T0000000000000000000000000
00G000S0000000S000000000000000
0000000000000000S0G00000000000
T000S00000000000G00SC0000000G0
00T00000G00000S000000000000000
T0S00000000G00000000G000000000
000000000000000000000G00000000
0G00000T000000000000000000SG0S
000S00000000S00000000000G0000C
0G00000S000000000000000S000000
00000S00000TG00000000000000000
00T000000000000S000000SG0G0000
0GG000000000000H000000000S0000
000000000000S0000000000000000T
000000SS000C0000000000G0000C00
000000SS000G0C000000000000C000
000000G0000S0000000000S00000GT
G0T000000000000000000000000000
00S000000T000S00G0000000000000
0000000G000000G000000000000000
000000000000000T00000G000S00S0
00000S000000000000000000000000
T0000G00G0000000000000000S0000
00000000000G0G0H00000S00000000
0S000000000S00G0000G0000000000
00T00000000G000G000S0000000000
0S000000G000000T00000000000G00
