0000000000000000S0000000000000
S00000000000S000000000000T0000
0000000S000000000000000T00S00G
000000000T000000G00S0000000000
000000000000000000000000G00000
0G000000000000000000G00B0000SB
00000000S000GG00S0T00000000000
T00000000000000000000G000S0000
0G00000T000000000000000000000S
0T00000G0000000000G0B000000000
G000000G00000000000T0000000000
0000T0000000000000000000000000
S00000000000000S00000000000000
0000S0G0G0TS000MB0000000000000
000S000000000000000000000000S0
00000T00G000000000000000000000
S000000000S00000000000000GGM00
000000000000000G0000000000000T
000000000000000000T00000G00000
0S0000G00000ST000G00000000B000
0S00000T0000000000000000S000G0
S000000000S00M000000000M0T0000
00000000G00000000000000G000000
0S000000G0000TG000S0000000B000
0000000000000G0000000S00T00000
00000000S0000000S0000000000000
00000000T0000G0000000000000G00
00T0000G0000G00000000000000000
G0S000000000S0G000000000000000
000000000000000000000SS000000M
