0000000000000000G00S0000000000
0000000000000000S0TS0G00000000
000000000000000000000000000000
0000000G0000000000000000000000
T000G00000000000000000G0000000
00G00000000S000G00000000000000
00S00T00000000000000S000000000
0GG0000S0000000S0000T0000H0000
0G00000000000G0H00000000T00SS0
0000000000000S0ST00000G0000000
0S00000S00T00000000000000000G0
00000G0T0000000000000000000000
000000000G00000T00000000000000
000000G0000000000000000GHS0000
0G00000000000S000T0000S000C000
000000000S0T00000000S0G0000000
000S00000G00000000T00000000000
000S000S0000000000000000000000
S00000000000000000000000000000
000000G0000S0G0000000S00H00000
00000G000000000G000000000000S0
0000S0000S00000000000000000000
00000ST00000000000000000000000
0000000G0S00000000G00000000000
0T0000000S00000000000000000000
00000000000000000G0000000000SG
000T00000000000000G0000GS00000
00G0T000S000000000000000000000
00000000TG000S0000S0000000000C
0000G0000000000G0T000000000000
