0000000g00SS000000000000000000
000g000S0000000000000g00000000
0000t00000000000000000000S0000
000000g00t0g00B000000000000000
0000St0000000000g0000000000000
000S0g00t00000000g000000000000
0000g00000S0gS00000000000t0000
0t0g0000SS000000000M00MM000g00
00000S000000000000S00000000000
0000g00t00000000S0S00000g00000
0g0000S000000t0000000000000g00
t0000000S00000S0000000g000M0g0
0000000g0000g0000000BS00000000
000S0000000g0gB0000000S0M0000M
000000000000000000g00000000000
0g0000000000000t000S00000000S0
0000000S00SM00g00g00000000B0M0
000000000S00000000S00000000000
00000000S000000000000S00000000
S00St0M0000000000M0000000M0000
000000000S0000000000S00000000g
000g00tSg0000000000000S0000000
00000000g0g0000000S00000000000
00t00000000000g0000000000000S0
0000000000g0000gS0SB00t00000M0
00000000000000000000S0t0000000
00000t00S000000000000000000000
gt00000000000S000000000gB0S0M0
t0000000000000000000000S00000S
0t0000000S00000000000S00000000
