0000000G00000S000G000T00000000
000S0000S0T00000000G0000000000
000000000000000T00000000000000
000000000000000T0000S000000000
0000000000TS00000000000G0G0H0H
00000T000000000S0GSG0000000000
0000000000000T00S00000000S0000
00000000000000T0000000G00000G0
00000T0000G0000S0000000000S000
G0000000T0S00000000000S0000000
000000000000000G00000000S00000
00000G000000000000000T0000S000
000T00000000S0000000S000000000
0000000000000000000000000T00S0
G000000000000000T0000000000000
SS0000T0000C000000000G00000000
000000000000GS000G000000000000
00T00SS000G0G000000000000H00H0
000000TSS000000000G0G0000000H0
000000S0000000000T00000G000S00
0000S0000000000000000000000000
00T0000000000000000000S0000000
0000000G000GH00000H00000000000
S000000000000000000000S0000000
0GT000000000000S00S000000G0000
00000000000000G000000000000000
00000TS00000000G00000000000000
0000G0000000G00000000000H00000
0G00S00000000T0000000000000000
0T000000000000G0S0000G00000000
