000000S0000000S0000M0000000TG0
0T00000000000000000000G000S000
00T00000000G000000000000000000
000000000000000G00000000T00000
0T0G0000000000000000000G00S00S
0000G000S00G0S00B0T00000000000
T0S000000000000000G00000000000
00000000000000000000G0G0000B00
00000000000G0G000000000000T000
00S000000TS00000G0M00000000000
0000000000000SS000000M000G0000
0000000G00000000G000000000T000
00S000000G0T000000000G00000000
000S0000000000000000T00GS000M0
000T00000000000000000000000000
00T00000S0S00000M0000000000000
0000000000T0000000000000000000
0T000S000000000G000G0000S00000
0000000000000000S000G0000000S0
0000000000G0000000G000000B0000
0000T000S0G000000000G000000000
000000ST000000000S000000000000
00S0G0T0000000G00B0000000000S0
SS0000000000000000000000000000
0T0G0000000SS00000000000000000
00000000G00000000SG00T00S00000
00S0000000S000000M000000M00000
000000G00000000000000T00S00000
00000TS0000000000000000000S000
00000S000ST0000000GG0000000000
