0G000S000000000000000S00000000
S0000000000T00000000000000G000
0T000G000000000000000000000000
0S0G00G000T0HS0000000000000000
00000000000000000T000000000000
00T0000000000000S00000G00000S0
S00GS00CT00000000000G000000000
0000000000S0TG0000000000000000
00G0000000S000000000000000000T
0000G000G000HT0000000000000000
G0G00000T00S000000000000000000
0000000S000GG0000000000000TS00
0000T000000000000000000000000G
000000S000T000000G00000G00H000
S0000000000000TS0000000C000000
00000T0000000000000000000S00G0
000000S00000G0000T000000000000
000T0000000000000000000000S000
000000S0000000G000000ST00G0000
00T000000000000000000000000000
00000000T0000G000000G000000000
00T0000G0000000000S00000G00000
00000000000G00000G000000000000
0S00000000S0000000G00000000000
0000T000S000000000000000000000
0T000G0000000000G0000000000000
0T0000G0000G0H0000000000000S00
000G00G0000H0S000000T000000000
0000T0000G0000000000000G000S00
0T0G00000S000000000G0000000000
