0000000000000000SG00T00000S00G
000G0S0000G000000000H0TH000H00
000000000S000000000000000000S0
00ST00000000000000000000000000
00000T000S000S0000000000000000
00G000T00G00000000000000000000
0000G000000000S000000000000000
0T0000000000000000000000000000
00000000000T000000000000000000
T00000000000000SS000G00000C000
00000G00000T000000000G000000H0
S0T0000000000S0000000G00000000
000G0000000GH0HH000H00H000H000
S0000S0000000000000C000000C000
0T000G0GH000000000000000000000
T000000S0000000000000000000000
0000000G00S0000000TG00000H000H
G0000000000000000000000000G000
0000S00000000000G000000000000T
00000000000S00000000G00000S000
0G00S000000T0S0000000000000000
0000S0S0000G0C0000000000000000
00000S00G0T000S00000000000000C
0000000000T0000000000000000000
000G0G0000H0H0000T000000000H00
0000000000000T000000G000000G00
S0000000G000000000000000000000
000000S0000000S00G00000000000T
00000000000T000000000000000000
0T0000000000000000000000000000
