000000000000000T0000S000000000
0G00000000G00H00SH00000S0000H0
00000000000000G000000S00S000C0
0000000000G0000000000000000000
00000000000000000000T0000000S0
0000000000000000S00S0TC0C00000
0000000000GGH000T0H00000000000
000000000000000000000000000000
0000T0000S00S00C00G00000GH0000
000000000000S00T0000000G00000G
0G00000000S0000000000T0S000000
00000000000G00000000G000000S00
00S0S0T00000000000000000000000
0000T00000000000000S0000000SG0
0TG00000000000000G000H00H00000
000S0G00S00000000G00H000000000
G0000T000000000000000000000000
0000000G00000T00000000GHHH0000
0G00S0000G00S0H000C0000000TC00
0000G000G00000000000000000S000
000000000000T0000000G00000S000
000TS0S0000000000CC00C0000G000
000000000G000T000000S000000000
0000000S0S0C0000000T0000000000
00T0000000S00000000000G0000000
T00S0000G0000000000000000000G0
TG00000000G0000000000S0000SH00
0T000000000S00000G00000000S000
0G00000000000000G0000000HS000H
000000000000000000T00000000000
