S0G0S0000000000000TC
0000S0000000G00S0000
0TG00SG0S00000000000
0G000000S0S000000T00
0T0G00S0000000000000
000G000T00000G0000SS
0000000000T0G000G000
TG000000000000S00000
G0T000S0G00000000000
000ST000S00000000000
00000G00S000T00000G0
T00000S000000000000G
00GT000000G000000000
00T000000000000000S0
00000000000000S0T000
000S00T0S00000000G00
0000000000000G0T00SS
0000000000000000S00S
000GS00SCG0000000000
00G00G00000000000000
