0GS000000S000G00000C0000000000
00000G0S00S0000GCH000000000T00
0000000G00000T00000S0000000000
0GT000000000S0S000000000000000
00000T00000000000000G000000000
0000S0000000000000000000000000
00000000SG000000000S000000T000
000000000000000000S00000000000
000000T000000000000000000000S0
00000S000000G00000000000000000
00T00000G00000000000000G00S000
0S00000GG0000000000000T0000000
0T0000SS00C0000000000000000000
0S0000000G0000T0000S0000000G0C
0S0000000T000000SGG0C000000000
00G00T00000000000000000S0000G0
0000G0000000T00000S00000G00000
000S00000000000000000000000000
0T00000000000000S0000000G0S0G0
0G00S00000000000G00S00000000CT
0000000000T0000000000000000000
T0000000000000000S00S000000000
G0000000S000000000000000S00000
000000T0000G000000000000000000
000000000000000000000S0000G000
0T0000000000000G00000000000000
000000S000000T0000000GS0000000
T00000000000G000S0000000000000
00000G000000000000000000S00000
00000000000000000000000000S000
