000000ST0000000GG00000H0000000
00000S0T000000000G000000000000
S00000S00C0000000000000T000000
00G0S0GT00000000000S0000000000
000T00000000000000000000000000
0000000G0000000000000000000T00
G0000GH00000T00000000000000000
00000000G000000000000T00G00000
000000G00000T0000000000000000G
000000000000000000TS0S00000000
000000S00000000000000S00000000
000000000S0T000000G0000SC00000
000000000S00000000000G00T00000
000GS0000000000G00SH0000T00000
S000000000000000S0000G00000000
0000000000S000000S00000C0TG000
000000000000G00G00000000H000S0
G0000000000000000S0000000T0000
000000000000000000000000G00T00
000000G0S0000000000GH000000000
0000000T0000S000000000S0000000
0000S00000000G00G000HS0000T0C0
000S000000000S00000000000G0000
00GG0S0H0000000000000000000ST0
00T000000000000000000000000000
0000T000000000000000000000000G
0000000S0000000000000000T0000S
000000S000000T000S0C0000000000
000000000000T0000000G000000000
0000000000G000000GS000000T00S0
