0T0000000000000000G00000000000
0000000T00S000000000000G0SG0C0
0000000T00000G00000SS00C00G000
00S0000G0000000000000G00000000
00000000000TG00000000S0S000000
00000G00S0000000T0000000000000
000000000000000S000T0000000000
000S000000T0S00000000G000C0000
00000S00000G00000S0CG000000000
000S0000000T000000000000000000
0000000000GS00000000000G000T00
G00000000000000000000000000S00
0T000000000000000000000G000000
0000SG000000000000000000000000
000T0000000000000G000S00000000
00000000T000000000000000000000
0G0000000T0000000S00000000G000
0S0S000T00000000000C00000000GG
0G000000S00000000000000G0000H0
000000000000000000G0000000S000
0000000G00000000G00H000000000S
TG000G0000S00000000H000000000S
T0000000000000000S000GG00H0000
00S0000000000000G000000T000000
00T0S0000000000000000000000000
00000000000SSG0000000000G00000
0000000GGS00000S0000000000H00C
00G0000S0000G00000H00000000000
00T000000000000000000000000000
0T00000000000G000000S000000000
