000000000000000000S00000000000
0000SG0000000000000S0000000000
000T0000000000000000000000S0S0
000000000000S00000S00000TG0C00
00000S00000000000G0G0000H00000
0000000S0000000000000G00000000
0000000TG0000S0000000S000C0C00
0000S000000G00000T00000000S000
00000000000000000000S00000000S
0000000000000G0000000T00000000
000000000000S00000000000000000
0T0000000000000S00000000000000
0000GG000000000S000000S0000000
000000000000000S000TG00G000000
00S000S00000000CC000GT000G000C
0000000000SG0000000000T0000000
0000TG00G0H000000000000000H000
S000000S000000C000T00G0000000C
000GT0G00000H000000S0000000000
G00000000000G00000000000T00000
0S000S0C000000000C000000000000
000000000000S0000000G000000000
00S0T0000000G00000000000000000
00000000G00S0000000S0000000000
G000T000000000000000000G0000S0
00T00S0SG0000G00000000000000HH
0000S00000G00000S000G00H000T00
000000S00000000G00G00H0T0H000S
ST00000S0C00000C0C000G00000000
00000S000000T000000000000S0C00
