00T0S0G00000000000000000000000
00000000000000000000S000T00000
G0S000000000000000000000000S00
0000T000S00G000000000000000000
000000000000000G00T00G00000000
T0000000S0000000S00G0000000000
0T0000000000000000000000000G00
S0000000S000C0T0000000C0000000
00000S0ST0000G00000000000G0000
00T00000000S0000000000000000S0
000S00000000T0S000000000000000
0000000000S000000000S00T000000
T0000000000000G000000000000000
0T000000000S00000000S000000000
T0000000000000000000000000000G
00000000G00000000S00SC000C0T0C
ST000000000G00000S000000000000
000000000000T00S0000G000000000
00000000000G00G000T00000000000
000000T0000000000000000000000S
00T0000S00000000000G0000000000
00000000T0000G000000S000000G00
00S000T000000000000000S0C00000
0000000000G000000000S000000000
000000000T00000000000000000000
00000G00S00000S00T000000000000
0000000000000S00T000000000G000
0000000000T00000000000G0000000
000000000000000000G0T0000000G0
S00000000000T000000G0S0CG00000
