G00000000000000000000000000S00
0000000S0000000000000000000000
0SS0000000000000T0000000000000
0000SG000000000000000000000000
0000S00G0000000S0G000000T00000
0G00000000G0H0000000T000000000
00000000000S0000000000000S000T
TG000000G000000000000000000000
00G0000000000000S00000G0000000
00000GT000000G0000000000000000
00T00000000000000000G0000000G0
00000000000000T0000S00000000G0
000T00000000000000000000000000
00G00000S00TS00C00000000000000
GG00000T0000000000H00000000000
00S0000T000000000000G0S0000000
0S000S000000000T00000C00000000
0S0000000S00000000000000000000
0T000000G00000000000G0000H0000
0S00000000000000000S000000000C
S0T0000000000000000000S0000000
0S0000000TS000C000000000000000
00T0000000G000000S0000000000G0
00S000000000000G0000000000G000
000000000000000000000S00000000
000000000000000000T00000000000
00SS000000C00T0000000000000000
0000T0000000000000000SG0000000
0000T000000000000000S0G0000000
000000000000TG00S0000G0000000H
