S000S0T00000000000000000000000
0S0000000T00000000000000000SM0
000000000000S00000G0000G000000
00000000GS0G0000000T0000000000
0ST00S0000MM0M000000GM00000000
00000000S00SG000T0000000000000
000000G000000000000G0BT0000000
T0000000000S000000000S00000000
0G00T00000G0S000000B0B0000B000
0000000000000000G000000GB00000
0000000S000000000000GG00000000
0000GT0000000000S0000S00000000
000S0000T000000S000000000000GM
00S000000000000000T000000G0000
000G000T00G000B000000000000000
000S000S000000000G00000000G000
00G000000000S0G000000000000B00
0000000TS0G000000000000G00000B
0000000G000000TS0000000000GB00
0000000000000000000000000GG000
0000000T0000000000000000000000
0000000000000000T0G00000000000
00000T00G000G00000000000000000
S00000000000000000S0000G00T000
S0000000T00000000000000000000G
0G000000000GS00000000000000000
0000000000000000000000TG00G000
000000S00000000000G000T0000000
0000000000S0S00T00000000000000
00S000G000G00S0000000B00000T00
