000G0000000000S000000000000000
0000T0S00000S000C000000000000C
00000000000000000G000G00000000
000000S0000000S000000000000G0T
0G000T000S00000000000000GH0000
0000000T00G00000000GH00S000000
00T0G00G00S000S0000H00000CH000
00000000000T00S00000S000000000
0000T0000000000000000000000000
00000000000S0G000S0000000000G0
0000000000000000T0000000S00000
0000G00000000G0H0000000T000000
0G000G00SS0000000T000000H00000
S000000000G000G00S000000000000
T0000000G000000000000000000000
00G000000S0000000000G000T00000
000000000000G00T00000000000000
000T0000000000S0000S00000000G0
G00000000000000T00G00000000000
000T00000000000S00000000000000
00000000T0G0000000G0S00000S000
G0000000T0G0000000S00000000S00
0T0000000000000000000000S00000
TG000000000000000000S000000000
00000000G00000T000000S00000000
T00000000000G0000000G000000000
0000ST0S00000000C0000C00G00000
T000000SG000000000000000000000
0000000G00000T000GH00000000000
00000000T00000000000000S000S00
