000000S0000000000000000000000g
0000S0000000000g000g0000000000
00000000000000000000S00000000t
00000000000g00S0S00t0000000000
0t0g0000S0000g000000000B0B0000
0000000S0t00000000000000000000
0g0g000t000S0000S000000000000M
00000t00000000000000g0S0000000
00gg0B00000000000BSB0S000M0000
00t000000000000000g000S0000000
00000g000t00000S0000S000000000
0000000t00000S0000000000000000
000t00000000000000000000000000
0t00S0000000S0000000000000000M
0gg0000000000000B0S00000BS0M00
0S000S000000000000000000000000
000000S0S0000000000M0tgg000000
00gt0000000SS00000000000000000
000t000000g00000000000S0000000
0000000000000t0000000000000000
0000000S00t000000000000g00g0S0
000t0000000gS00000000000000000
g00000S00g000000S00000BB000000
0t0000S0000000g00000000g000S0B
000gg000000000tS00000000000S00
0g000000000000000000000S000000
S000S0MM000M000000000000000000
0000000g000000000St00000000000
000t0000000000000000000g000000
00S00t0000000000000000000S0000
