0000000S0000000000000G00GHS000
S0000000G0000T0000000000000000
0SG00000SG0T000000000000000000
0G00SG000000T00000000000S00000
0S000000S000000000C0000000T000
0S000000T000000000000000S00G00
S000000000T000000S0C0000000000
0000T0000G00000000000000000000
G00G000000S00000000H0000H0T00S
000000000T000000S00000000000S0
0000000G00000TS00G000000000000
000000000SS00000000C0000000000
000000000S0SGC00000C00000C000C
000000G00S00T00000000SG0000000
0000000000000G0000S0S0000000C0
00000000000T0000000000G0S00G00
00000G000000000000S000000000G0
0S00000S00T0000000G000000G0000
00000000000000S00T0G000GS00000
0T0S0000000000000000000G00S0C0
00000S0G000000G00000T0000000H0
TG0S00S0000000000000000000GH00
000000000000000000G000000G0000
000G0S000000000G0000000000000H
0S0000000000000T00000000G00000
00G000000000S0000000000T00000S
000G0000S000000000G00000000TH0
0000000000000000000GG0000000S0
00000000000S00000000GG00S0H000
T000000000000000000000000G0000
