0G0S00S0T00000000000C000000000
000000000000S000000000T0000000
00000S0G00000000000S0G00000000
000G000000S0000000000000000000
0S00000000000S00000000000000G0
0T0GS00S00G0000H0C000000000000
0G00000S0000000000000G000000ST
S0S0000000000000C0000000T00000
0000000000000000T0000000000000
000000000000000T0S0S0000000000
000T00S0G0000000000000S000000G
0000G000000000000000000000GS00
000000000G0000T0000000G00000H0
G00000S0T00000000000000000000G
S00000S000C0000000000000000000
00T00G000000000000G00000000000
00000T000000000000000000000000
0G00T000000000000S00000S00G000
00000S000G0000000G000000000000
0000T0000S000000000G0000000000
00000000S00000000G000000000000
00000000G00000000000000000000T
S0000000000G0000T00000000S0000
0T00000000000S0000000G00000000
0000SG0000000S00000000000G0H00
000G0T0000S000000000S000C00000
000T000000000SG000000000000000
0000000000S000G00T0000000000G0
00000T00G0000000S0000000000000
000TG00S00000000G00H0000000000
