T0000000G00S000000S0
0000T000G000G0000000
0000000GT0000G000000
000000ST00000G0S000G
S00S0T00000000000000
00S0G0S000000G000000
0000000000000000000S
G00000SG0000T0000000
00S0S00000000CG00T00
0000G00G000S00000000
00GG00000T0000000000
000T00G000G000000000
00S0000000000000000S
0SS00000G0000000C000
00000GT0000G000S000S
TG000G0000000S0000S0
0000TG000S000000000S
000G00000T00000S0S00
000T0000000000000000
S00S000000T000000000
