S00000G000000000GT000000H000SH
000000000T00000000000000000000
0G000T0000S000000000GHS0H00000
0000S0000000000000000000000000
000000G000G0T00000000000000000
00S00G0000S0000T0000C000000000
00000G0G000H0S0HT0000000H00000
00000T00000S00000000000000G000
GT0S000000000SCCC0C00000C00000
00000T000000000G00000000000000
S0G0000G000000T0000000000000S0
00G00000000000000S0G00H0T00000
0000TS0S0G00C0000000G0000C0000
00T0000G0000000000000000G00H00
0000T0000000000000000000000000
000S000000GS000T00000000000000
S000000000GS0000000G0000000000
000G00000000000T000000G0000000
0000000000T00G0000000000000000
00T0000000000S00000000G0000000
00G000S00T0000000S00000C000000
00T000000000000SG000S0C0000000
000000000000G0000000000T000000
00000S00G0000000G0000000000000
00G000000000000000000000000000
00000000000000000000000T000000
000000G000000000000000000T0G00
G000S000000G0000000000T0000SH0
G00000G00T00H0S0000HS0000H0000
0000000000000T000G000000000000
