G0G0000T000S00000000
0G0000000000S00000T0
0000S000000000000G00
000000000000S000000T
0GG000T0000000000000
0000000000000S000G00
S000SG0000000G000000
0000000T00000000G000
000T0000000000S00G00
00T00000SG0000000000
000000G00S0G00000000
000000G000000000T000
000S00000S00000GG000
SSGT00000000G0000000
00000000ST000G000000
T00G0000000G00S00000
00S00000G0T0000000SG
000GS0000T00000S0000
0000G000T0000000S00G
00000S0G00G000000000
