00S00000000t00000S000M0000g000
000000000000t00000000000000g00
000000000g000S00000t0000000000
0000S0000t000g00000000000S0000
00t000S0000000000000000S000000
0000000000S0000000000S0t000000
00t0000000000000S00000000g0000
000g0t00000g000000B00000000000
000000000SgS00000000000M000000
00g00g0000000t0S00B000000000S0
0000000S0000t000000g00g0000B00
000t000000000000000000S0000g00
0g000g00tS0000000000B000000000
00000000000000g00000000000t0S0
000tg00000000000000g00000000S0
00000000S00000S000000g0Mg00000
000000000g000t0000000000000000
0000SSMt000000M0000000g0g00000
St0000000000000000000000000000
t00000000000000S00000000S00g00
t00000000000000000000000000000
00000S000S00000g0g0tM000000000
0000000tg00000S000000000000g00
0000S0000000000000000000g00g00
0S00g000000000S0000g000B000000
00S000000000000000000000000000
S0000000g000000000g0000SBB0000
00000000gt00000000S00000000000
000000000g000000000g0000000000
0000St000000000000000000g0g0B0
