0000000000T0000S0000000000000S
0S000000S00000000T000000000000
00000000000G00S000S00000000000
00000000000000T000000000000000
00000G00G00B0T00000B0000000000
000S00T000000GS00000M00000G00B
0000000S00000000G0S0M0000000T0
00000000000000S00000000000T000
TG00G00000S0000S0000000000000B
00000S00000000000000S000000000
000S000000000000000T00000S0000
0S00000000T000000G000000000000
TS00000S000G0000000000000G0000
000S00G0T0000000000S00000M0000
000000S0SMT00000G0000000000G00
00000T00000000G000000000000S00
000000T00000000S00000G000S0000
0S000000000000ST000M0000000000
0000000000G0000000000000000000
00000000T00S000000000000000000
000000000000000000TS0000000000
0000T00S000000000000000G000000
S0000000000G000000T0G000000000
00000000000T00000000000000G000
0S00000000T000G0S0000000000000
0000000T0G00000G00000000000000
0000G00000S000000T0000S0000000
0S0T00G000000000S00000M000M000
000000000000000S00S00000000000
0G000000000S00TG00000000S00M00
