0000G00G00T000000000
000GT0000S00S000G000
G00000000G0000000000
00T000000000G0000000
0000000G000000G00000
000000000S0G0S0T0000
S00000000S0000000000
000GG000000000000000
0G000T0000S0000000S0
T00G000000S000000000
0GT000000000000G0000
0000000000000000T0G0
0000000G00S0S0T00000
0000000TG000S00G0000
00000S00G00G000000S0
00000S0000000000S00G
00000G0S000G0000S000
T0G00000000000000000
000000SGG00000000000
00000S00000T00G00000
