0000000S0T0S000000000000000000
G0000000G000B00000000000000000
00000000GG0S00000000000T000000
000000G00T000000000S000000G000
G000000G00000000000000000000SS
000000T00000000000S000S0000000
0000GS0000000000000000000000T0
0000000000000T000000000000G000
00000000000000000000000000G00S
00000000000T000000000000G00000
000000T0000000G000000000000000
00S00000000ST000000G000000000G
00000000000000G00000000000000S
00000000000G0T00000000000S0000
0000000000000S0000000000000000
0000S000T0S000M000000MG0000000
00000T000000000000000000000000
0000000000000000T00G0000000000
0000T000S00S000000000000000000
00G0000000T00000S0000000000000
00000000000G000S0000000T000000
000000000000G000S00000000S0G00
0000T00000000000000000000S0000
000000000000000G0000000000GB00
T000S0000GG0B000000000S0000000
00000000S0T0000000000000S00000
00S000000000000000000000000000
000TG000000G000000S00000000000
0T0G000000000G0BB000000000000S
G0000000000GT0000S00S000000000
