G00T000000S000000000
00000G000ST000000G00
000G000T0000G0000000
0S000000000000000000
00GS000000T0G0000000
00000000S0000000000T
T00G0000G00000000000
000000000000000G0000
G00GT000000000000000
000T00G0000000000000
0000G000T00G00000000
0000S00T00000000000G
0G000T0G000000000000
00000000S00000G000T0
00000000T000000000G0
00T00S00000000000000
0S000G00T00000000S00
00000000000SG0G00000
000000000T000G00000S
0G00000T000000000000
