000000G000000000T0G0
S0T0S0000000000G0000
0000T000G00000G00000
00T000000000000G000G
G0SG000000000ST00000
S00S0000000000000000
00T00000000000000SS0
G00000S0000000000000
0G000S000G000T00000S
00T0G00000G000000000
00G000000S00S00G0000
000T00G00G0000000000
0000000S0000TS000000
0G0000ST000S0000000G
00000G0G0000000T0000
0000000000000000S00T
0ST00000000000000G00
000000000000000000G0
000000S00000S0000000
0G00000000000S000S00
