00000T00000000000000S0000000SG
000000S00000000000000S0000000T
0000000000000000000T0S0000000S
00ST000S000G000M00000000000000
0000000T00G0000000000000000000
0000000000000S0000000000000000
0SG000000000000000000T00000S00
000000S0T000000000000000000000
00000S00000S0000M0000000000000
000TS0S0M000000000000000000000
0000G000G00T000000000000000000
00G00000000S00000T000000000S00
000000000S0000GT00G000S00000B0
G000000S0000T00000G0S000000000
G00000000S00000000000T0000S000
000S000000000G000G0000T0000B00
00000000T000000000000000000000
00T000000G0S000000000000000000
000GT00000000000000000G0B00000
G000T0000000000000000000000000
000GTG00000000000SB0B0000S0000
000000000000000000000G0000000T
0000000G00G000T00000000SS0B000
000T00000000000000SGG00000S000
00G00000000S00SM0G000000000000
0G0000000T0G000000000000000000
G0G0B0B0000000T00000SS00000000
0000G00000T000S00G000000000000
00000S0G0T00000000000000000000
00000T000000000000SS00000M0000
