S0000000000000000000000TG0G000
00000000000T00000S000000000000
TS0000000000SCGG000000000000C0
0T000000000000000S000000000000
0000000000S0000000000000000000
000000T0000000000000000000000G
00S0000000000S00C0000000000000
S0000G00000000G0000T0000000000
0000000000G0000000000000000000
00GG00000000000000000000000000
00000S0G00000000000000000G0000
000000000000000000000000000000
00000GG0000000000000S00000000H
000000000000000000000000000000
000000000T0000000G000000000000
0000SS0C00000G00000T000G00HC00
000S00000000000000000000000000
0000S0ST0000000000C0000GC00G00
00T000000000000000000000000000
000G00G00000000000000000000000
000000000000T00000000000000000
00000000000000000S0000T0000000
00000S00G000000000000000G00000
00000000G00000000000000000G0T0
0S00000000T00000G00000000G000H
0000000000000000000000T0000000
000000000000000000000000000000
00TG0000000000000000G000000000
0000000000000S0000000000000000
000G000000000000T0000S0G000000
