00TSGS000000GB0000000MM0000000
0000G000S0000000S0000000000T00
0000000000000T0G000S0000S0000G
0000000T0000000000000000000000
000GS00G0000B00000000000000B00
000000000S0000G00000000ST00000
00G0S00000000000000000000STM00
00000000000000000000S000000000
0G000000S0S000M0000M0000000M00
00SS0G00000M000000000000000000
000000000000T00000000S00000000
0000000000000T000000000000000G
00G00000T0000000S0G00000000000
00000G0000000000000000S0000T00
000000S00000000G000000000G0000
G00000S0000000T000000000G00000
0000000000S00000000000000T00G0
000G00000000000S000G0000000000
0000T0G000000000000G0000000000
0S0000000000000000G000GB00S000
0000000G0G00000000000000T00B00
00000T0000000000S000000000000S
000000000000000G000000000000TG
0000T000000000G000000000000000
000000S00000000000T0000000G000
S0000T000000000000000000000000
G0S0G000S000MB00BB000M00M00M00
000STG00000000000000000000GS00
00000000000000000000S000ST0000
000000000000000000G0000T000S00
