0000S00000000gS0000000000000g0
00t0000000000000000000S00g0000
000000S0000000gg0000000t000000
00000000g0000000S0000000t00000
000000000000000g00000S0000000g
0000S00000S000000000g0000000M0
00g000000g0000S0B000000000B000
000t000S00000000gS000000000000
S000g000000S00000g0B0000000000
0t000000000000S000g0S0000000g0
t00000000000000000S0000000000S
0000t00SS0000000M0000000000000
t00000g00000000S00g00000B00000
00gSSg0000B00M000MB0000B000000
00000000t0000000000000S000g0S0
0000000t0000g000g0000000000000
0S0000000000g000t000S000g00000
000000t0000000000000000000000g
0000000S000000gg00000000B0000S
00S00t00000000000S000000000M00
0t000000000000gS00000g000SM000
0000g0g00000S000B000000t0000B0
0000000t000g00000000g00000B000
0000g0000g000000000000B0000000
0000g00St0000g000000000B0B0000
000S0t0000g000000gS000B00000M0
000000S000000S0t0000000000000M
0000000000000000000000000g0S00
000gS000000000St0000000g000000
00S0000000g0t00000000000000000
