00000000000000S00000000T000000
00S000G00000G000T000000000000S
000S0000000000000000000000T000
000000000000000000000T000000G0
00G0000S00000000ST00C00000G000
0000T0000000000000000G00000G00
0000000G0T0GH000000S000000S000
00000000G00000000S0T0000000000
00000000000GS00000000000000000
S00S0000T0GG000000000000000000
00000000000000S00G00T00000S000
000S00G00S00000000000000000000
00000T0000S00G000S000000000000
00000G0000S00000000SCT00000000
00000T0SG00000000000S0G0C00000
T0000000000G000000000S0SC00000
0000000000000S00000G0000000000
0T00000000S000000000G00G000000
0000000G00000S000T000000000000
000G00000S00S000000000000000T0
000000SG000000T000000000000000
00G0T0000000000000000000000000
000S000S0C00GG000000000000000H
G000000000G000000000S00T000000
000000000GSSC00T0000000000G000
00000T00000000000000G000000000
00TG00000000000000000000G00000
0S0000000G00000000000000000T00
0000000000T000000G000000000000
G00000T0000000000S000000000000
