0000000000000000ST0000000S00G0
00000S00S00000T0000000G0000000
G0000G0000BB00000000000S0B0000
000000000000000000000000000000
000000G0G000000B0B000000000000
0T000000000000000000S000000000
000GT00000000G0000000000B00000
S00000000000000000000000000000
0000000G00000T0000000000S000S0
00S0T0000000000000S000000MM000
00000000T00000000000G000000000
00S00000GG0000000B00000S0000M0
000000G0000000000000T000000000
00000000G000GB00S000T00000BS00
G0S000S0T00000000M0000G0000000
0000000000G0000000000000S00000
000G0G00S00B00000000000BT00000
0G0000G0000T000000000000S0000S
00000000S000T00000S0000000G0G0
000000000G00000T00S0000G000000
00000S0G0T00000000000000000000
0000000000T00000S0000000000000
0000T0000000G00000G00000000000
0T0000000000000000000000000000
000000000000T000000000G0000000
00000S00000000000S00000000000T
000000S000000000T00000S0000000
000T00000G0000000000000000000G
000000000000000000000000000G00
0000000000S00000000T000S0000G0
