0000S00000000ggS00t00000000000
00000000000000g0g000000Bt0S000
0000000000000000S0t00g00000000
00000000S00000000t0g0000000000
g00000000000t00000000000000g0B
00000000g000000000000000000g00
000000S000t00g0000000000000S00
000000000S000000000S0000000000
0000t00000000000000000g0000000
0000000S000000t00000000000g000
000000t00000000000S000S0000000
0000000000000000g00S000g000000
S0000000000S0000g000M000000t0M
0000000000000000000000t0S00000
0000g000S00S000000000000000000
g000000000t000gS00000000B0B000
00000gg0000000t000000BSBB000B0
0000S000000000000000000000000S
0000000000000000000t000S000000
00000000000000S0000S0t0000g000
S0000000000000t00S000000000000
00g00000000t000000000000000000
0000g000gt0000000S000000S00000
00000000S0000000000St000000000
000000000000000000000000000000
0000t000000g000g00000000B000B0
00000000S00000000t00S00gM0gB0B
000000000000000000000000000000
00000000000000000S0000000000t0
000000t000S0g0000000S000000000
