00000000S00000000G000000S00000
T00000S00S00000000000000000000
T000G00000S000S0C000G00000H000
S0T00S0000000000000000C0000000
G00S0000000000000TG00000S0H0C0
00000000T0000S0000000000000000
00000S000000000000000000000000
0000000000000000000000000T0000
G00S00TS0000000000000000000000
0000000000GT000G00000S00000000
0000000000T0000000000000000000
000T0S000000000000000G000G0000
000000000S00000000S00G00000G00
00000000000T000000000000G00000
00000000S0G00001000T000000000G
0G00000000000000S00G00ST000000
G0000000000000000S0S00000T0000
000000000000000T0000000000000G
G000G000000T000SS0000000H00000
0G0000S0000000000000000S000000
00G00S0S000000G000C00000000000
00S00000G000T0000S000000000000
0G0000000G0H00S000000000000000
000S000000000000000G0T000S0000
00T0S0000000G00000000G00000000
00000000000000000GS00000000000
000S00T00000G00G0S000000000000
0000000G000000000T000G000SH000
T000S00000S00000000C00G0000000
00000000000000000000000000TG00
