000G000000T0S0000000000000000G
00000S00000000000T000000000000
000000S0S000000G00000000T00000
000000000000S0000000000S000000
000000000000000000T0000S00000S
G0000000000000T00000G000000S0B
00G0000000000000000000T00G0000
000000GG0BB0B000B0000B0S000000
0G00S00000000G0S0MB000BMT0BM00
0000T00000000000G0000000000000
0000G00SS000M00000000M00000M00
0SG0000000T00S00000000000MM0M0
000000GT00SS000G00000000B0B000
00S00G00000000000000000S0000G0
000000000000T00000000G00000000
000000TS0000S0000M0000G000G0M0
000G00T0000000000000G000000S00
000G0000000000000000G000000S00
00000000000000T00G000000000000
0000000TG0000000000000G00000B0
00T00000000G000000000000G00000
00000S00000000S000000G0000000G
0000G00S000000G0S0000B0000M000
000000000000000SS00M000M00T000
0000000000000S00G0000T00000000
0000ST0000000S000000M000000000
0S0G00000000000S00M0T000000000
S0000G0000000S000000000G00000M
00000000000GT00000S0G000000S00
G0000000000000000GS000BS000000
