00000000000G0TS000000000000000
0000000G0000T00000000000000000
T00000G0S00000000G00H000000000
00T000000G00000G000000000H0H00
00000000T000S000000000000000G0
000000000S000G0000000SCG000T00
00G0G000000000T000000SH0000000
0000000000000G000T0G0000000000
00000000000S000000000000000000
00000000T000000000000000000000
0000G0000000000T00000000S00000
000000000T000000000S0000000000
0000G0000000000G00000000000T00
S00000T00000000000000000000000
000G00000G00000000000000000S00
0G0000000000000000000000000000
00000000000000000T00G000000000
0000000000000G00000000T000000G
0G0000G0000000000000S000000000
S000G000G00T00000S000000000000
0000T000SG00000000000000000000
0G0000S0T00000000000000G000000
S0TG000S000G0000C000000C000000
00000000000000S0000000000T0000
0000S0S000CG00C0T000000C000000
000S0T000000000000000000000000
0000000000T000G0000000G0000000
000000T000000000G000G000000000
00T000000000000000000S0G000S00
0G0T00000000000G00000000000000
