000000000000000T0000G000000000
000000000000000000000000000T00
000000T000GS00000000000G000000
00000000000000T00SS00000000000
00T0G0000000S00000000000000000
00G000000TG0000000000000000000
00000G000000000T00000000000000
0000000000000S00000000000T0000
00000G000000000000S000T0000000
00000S0000000S00000000000T0000
000000000000S00000000000S00000
GG000000000000000000T0000H000S
000000000T000G000S000000000000
G00000000000000G00000000000S00
00T0000000000000000G0000000G00
000000T000G0000000000000G00S00
0000000000000G0000T00000000000
00000000000S000000000000G000SG
00000000000000000000G00000000T
S000S000T000C00000000000000000
0000000000000000000000000S0000
0000T0S0000000G000000000000000
G00000000000000T00000000000000
000000000000000000000000000SG0
000000S00000000000000000000000
000S0000000000000000GT0000S000
000000GS0T000000000000000000G0
00000000000000000000000000TG00
000000S000000000000G0000000T00
0000000G0000000S000000T0000000
