00000000000000g000S0000t00g0SB
00g0g0SS00000000000000t0000000
0000000S0t0000000SM00000000g00
000S0000000000000000000000000S
0g0S0000000000000g000000t00000
00000000g00000000000000S00g0t0
00000000S0g0000000000000000000
gg0B00t0S0S0M00000B00000000000
00000S0000g00t0S0M000000000000
0000000tS000000g0000000SMg0000
00000g0000SSt0000000000g0000B0
00000000000000g000gB000t000000
000000000S0t00000000g000000g00
000000000S0000000000g000000g00
00St0000S000000000000000g00000
00000000g00000S000000S0000M000
000000000t0g0000000000Sg000000
000000000000000000000000t000g0
000000000g0000000g000000000000
0S0000000g000000000000t0000000
0000g0000000000000000000000000
g0t0000S000S000000000000000000
000S0t0000000g00S0000000000000
t00000000000000Sg0000gS0B00000
g0000000000000S0t000000g000S00
00SS0000000000g00M0000g000M000
000000000000000S000t0000g00000
000000g0g000S00B00000000S00000
00t00000000000000000g000S00000
00S0t00000000g000000g000000000
