00000S0000t00000000S0000M00000
0000S0S0000000M0000000g00t0000
0S0000000000t0000000000g000000
000S000000000000S0000000000000
00S0t0g0S00000000000M0g000M000
000t000000000S0000000000000000
000000S00000g0000SM00t0g0MM000
0000000S000t000000000000000000
0000S0000g000000000000tg0S000B
000t00000000000000000000000000
0S00t0000000000000000g0000S00g
00t000000000S0000000000g000000
00000000000g00t0000000000g0000
000gt0000000S000g00000S000000B
000S0000000000000000g000000000
000000000gS000t000000000000000
000t000000000000000S00000SM000
0000000000S0g0000000000g000B0t
00000t000000000000000Sg0000000
0000000000000000000000t0S00000
00000S000000000000000t0S000000
S000S0000t00000000M000000g00g0
0000000S000gt00000000000000g00
00000000gt00000g00BB0000000000
0St000000000gg0000B0000B000000
000000S0g00t000000000000000000
00t00000000g000000S0000000000g
000000000g0t000000000000000g0S
0000000g00S000000g0000B000tS00
000000000000S00000t00000S00000
