00000000G0T000000SG00000000000
G0G0000H00000000000000000S0000
00000000000000000SGG000000T000
000000S0000GG00000000000S00000
G0000000000000S0G000H000000000
0000000000000000G000S00000G00T
0000000S000000000TG00000000000
000TS000G000000G000H0000000000
G0000000000000000000000000G000
S000TG000000000000000000000000
T000000G000000000000000000SG00
0000000S00000T00G00000000S0000
S000T0000000000000000000000S00
S000000000000000G00S00000000C0
000000000G000T000000G000000000
000000S000000000000T0000S00000
S000ST0000C0000000000000000000
000000S0000000S000000000000C00
00000000000000T0000000000G0000
0000000000000000000000T00000G0
000000T00000000GS000000000000G
00000S00000000000000000G00T000
00000000000000T0000000G00S0000
00S000S00000C00000000000000000
00000S000000000000000TS0000000
0000000G00S00GS0000000T0000C00
000000000000000000000000000000
G0G0000000000HST0000000000S000
0G000T0000000000S000000000000S
00000G00000000T000000000000000
