00G0T0000GS00S000000
0T00000000000G000000
00000G00000T00000000
000000000SS00000000G
000000000000SS0T0000
00T00G0G000000000000
00T00000000000000S00
0G0000G0000000000000
00000000000000T00000
00T0000000G0000000G0
0000ST00S00000000000
000G000SS00000000000
0000G000ST00G0000000
000000000T0S0000S000
0G000G00S000TS000000
T000000000S0000G0G00
0000G00000000000000S
00G0S0G00S000C000000
00000G00S0000000T000
00000000000000S0000G
