000000000S0000000000S000t00000
0000000000000000000000t0000000
00g00t0gB000000S000S0000000000
000tgS000000000S000000000g0000
000S0000St000000g0g00000000000
000000000S000000000000000t000S
000000000000S0t000000S00000000
0000t00S0000000000S00000M000M0
0g0g0000000000000000B000000000
00000g000000000000000000000000
0t00000000000000g0000000000000
S00000000000000000000000000000
0S000S0M00000000t00000g0000000
0000000000000S00000S0g0g000000
00g000000000000000000000000000
0000000tS000000000g0000000000g
00000000t00S000000SM0000000g00
0t000000S0000000000000S0000000
000000g0000t00000S000000000000
00000000000000000000000g000000
000000000000000t0g000000000000
0g000t0000g000000000000000S000
00000000S0S00g0t00000000000000
0000000000000000g0000000000000
0g00000g00000000000000000t0000
t000000000000000S0000000000000
0S000000g000000t0000000000000S
t00000000g00g0000BS00000000000
00000000000000ggt0000000000000
t00000g0g000000000000000S00000
