00000ST0000000000000
TG00G0000000S000000S
000000S0GS00000000T0
T000G000000S00000000
G000000T00S000000000
000000000000GG000000
S0T00000S00000000000
0000T000000000000000
000T00000G0000000000
00G0T00000S000000000
00S000000G00000T0S00
000000000S0G000T0G00
00000000S00S0000000G
00000T0000000G000000
T00S0000S00000000000
0000G0000T000S000000
00S000000T0000000000
0T0000G0SS0000000000
0000T0000S0G0S000G00
0T00000000SG00000000
