00S0G000000000GT0000
00SS00C00T0000000000
0000T000000000000000
0000000S00000T00G000
000000000000000ST000
T00000S00G0G00000000
000000G00ST000000000
000G0000G000000S0T00
00000T000S0000000000
0000000S00G0SC000000
T000SS000G000C000000
000000000STGSC0G0000
000000T0S0000SC00000
000G0000G00000000000
00T00000000000S00000
000000000000T0S00000
00000000T000000G0000
00000000000000T00G00
TG000000000000S00000
G000000000000T00G0S0
