S00TG000G000S0000000
00T00000G00000000000
G00000G00000000000S0
0S00S000000000000000
0000000G00STG00S0000
000000G00000G0000000
GT000000G00000000000
GG0S00T00000S0000000
00000G0000G00000S0T0
00G00S00G0000000000S
000GG00000S000S00000
00000000S000000GS000
000000T00S000000G0G0
S0000000T000S000G000
0000T0000G00000S00G0
ST0000000000S0000000
T0SG0S00G00000000000
000G0G000T0000000000
T00G0SS0000000000000
S0000000GTS000000000
