00000S0G00000G000000
000000000T0000000G00
0T000000000000000000
00T0000G00G000000000
S00000S00G00000000G0
0000000S00000T000000
00TG000G00S000000000
TS000S0000G0000000G0
0G0000000000T0000000
0000000S000000000000
00S00000S00T00000000
0T0000000G00000000S0
G0G00000000000S00000
0S00000G0G0ST0000000
0000T000000000G00000
000T0000000000000000
0000000G0000T0000000
0000000G000000000000
00000S000000000000T0
0G0TG000000000S00S00
