00000000G0000000S00000T0000000
0T00000SG000000G0H00000000H000
S00000GT00000G0000000000000000
000G0S0000G000H00000000000T000
0000000000000000S00000G0SG0000
000000000000S000000000000S0T00
000000000G0G0000HH0S0000S000C0
0S00000T0000000S00000000G00000
00S0000000G0T00000S000000CCG00
0000000T0000000000000000000G00
T000000S00G0000000000GS0C000C0
0T0000000000000000000000000000
000000000000T000G0000000000000
0000000000000000G00S0000GH0HH0
0TS0G0000000000000000000000000
000T00000000000000G00000000000
G0000SS0000000000000000G00HT00
000000T00000G0S00G000000000000
0S000000SG0G000000000000H0H00C
00T0000000000GG000000000000000
00T000S000S000000000000G000000
0S0000T0G000000000000000000000
00T000SG000000000000000000S000
000000G0T000000000000000000000
0000000000000GS0S00000000000T0
00000000G00000S0000G0S00000000
G000T0000000000000000000000000
S0S000C0G00CT00000000C00000000
000000T00000000000000G00000000
0000000000000000000000T0000000
