00TS000S000000000C000000000000
G00000000000000S00000000G00000
0000SG000000T00000GS0000000000
0T00G0G0000000000H00000000000H
00000GT00G00000000S00000000000
0T000GS0000000SC0000000C000000
0000000TG000000000000000000000
0000000000G000S00T0S000C00000C
00000000000000000000G0G0000000
00000T00000000000S000G00000000
0000T00000000000000000000000S0
000000G000000G000000000000H000
0G0000000G00H0000T000S00000000
TS0000S000000C00000000000C0000
0G0T00000000000S00000000000000
0S0000ST000000CC0C00000C000000
000S0G0000G00000H0H0000000000T
0000000000000000000S0000000GG0
000000G000T00000000000000000G0
00T0000000000000000000000000S0
0S0000000S00000000000000G00000
0000S00S0000T000C0000000000000
000000000000000000000000000000
000000000GS00S00T000000000000G
0000000000000000S00T000G000000
00000G00000000T000000G0000H000
0000000G00000000S000000S000000
00000000000000G0000000G0000000
000G0T000G000000000000S0000000
0000000T0000000000000000000000
