0S0G0T00000G0SHC000000000000C0
0000000000000000000000T0000000
00000G0000000SS000000000000C00
00S00TG0S00000000000000000G000
00SS0T0000C0000000C000000C0C00
000000G00000S000000ST00CC00C0C
0T00S00000000000S000G00000G000
S000000000000000000G0000000000
00000000000T0000000000000S00S0
000S000000000G0000000000000000
T00000000000000000000000000000
T000G00000000000000000000000S0
000GS0G00000000000000000S0H000
00000S00T000000000000000000000
000T00000G0000000000000000G000
0000000000000G000000000SS0G000
0000000000ST0000000G000000G000
000T0000000000SG0G00000000H000
0000GG0000T0000H0000H000000000
0000000000000G00000000000000G0
G0000T00000000000G0H00000000HH
000000000000000000S00000000TS0
0000000ST000G0000000000S000000
000000000000000T000S0000000000
00T00G0000S000S00000000C000000
00T0000G000000000S00S00G0000C0
0S0000T00000000000000S00000000
0000000000T0000000000S00000000
S0G0T000SC00000000000C00C00000
00S0S0G000000G00H00000H0000000
