0000S000g0000g0000000000000S00
0t00000g0000000g0000000BS00000
t000000000000000000g0000000000
0tS0000S0000000000000000000000
000S0StM000M0000g0M00000000000
00tg0000000g0000000000000000S0
0g00000t00000g00000S00B0000000
0000t00000g0000000000000000000
000000000g000000000000000S0000
0000000000SS0000000000000g0000
000S00000000g00000000000000000
000gS00t00000g000S000000000M00
000g0000000000000g000000000000
00S000g000000t00S0000M00000000
00000000000000S0St000000000g00
000000StS0gM00000000000000g0B0
000000000g0000000g00000t000000
00000gg000000000000000000000t0
0gg000000t0000000S000000000S00
000000000000000g000000000g0000
g0S0g000S0000t000M00000000000M
000000000000000000000000000000
000S0000000000000t000000000000
00t000000S0g0000000gS00B000B00
000t0000S0000S000M0g00000M0000
00000000000000g000000000000S00
00000000000000000000000t00000g
g000S00000S0000t000000g0000000
00000t0000000000S0000S00000000
0000000000g00000g00000t0000000
