000S0000g0SM00000000000000000g
000000g000t0000000000000000000
0000t00S000000000000000g000000
0000000000000S00000000gS00g00M
0000S00000S00000gM000000000M0g
000S000000t00000g000000g000000
00000tg00000000000000000000000
0000g000000t000000000000000SS0
00000t00000S00000000000000S00M
00000000000S000000000000000000
00t0S00000000g000000000g0B00B0
0000S0t00000000000000000000000
0000t0000000g000S000000000000g
S00000000t00000000000000S00000
g000000g0000000000000t00B0000B
00000000g0000t0000S00000000000
00000g000S000000000000gt00000S
00000000S000000g00000000000000
S0000gt00000g00000BS00000M0M00
0000000t0000000000g00000000000
0t000g000000000000000000S00000
000000g0S000g000000000000B00S0
000S00g000000000000000000S0000
0000000tS0000000S000000000000g
0S00000g0000000000000t00000000
000000000000000000000S000000t0
0000000000t00000000000S0000S00
00000000000000g000000000tgB000
00S0000000g000000000000000000S
0S000000000000000t000000000S00
