0000000000000000000000000g00t0
000gS0t00000g00000000SB0000000
000000000000t0000000S0S0000M00
000000gSg000t0000000B000B0S000
000g0000000000000000000000t000
S00g00S00000000000000000g000M0
g0000000g00BS00000000000B0000t
0000000000000000t00000000g000g
0000S000S00t000gM0g0000B000000
000000000000000t00000000S00000
00000000S00g00g000000S0B000000
000000000g00tgB000000000S000B0
0g000000000000000000g000000000
00000tS000S000000000000gM00000
0000g0000gS0000000t000S0M000M0
00000000000S0000000000t00SM000
000000S0t0000S00000000000000g0
0000000000000000000000S0000S0g
0000t0000000000000000000000g00
000000000S0000St00000000000000
0000000S0000g000000S0000M0000g
0g00000000000S0000000000000000
000000000000000000S0000t000000
00000g000tg0000000000000000000
000g0g00S0000000S0M0000000t000
000000000000t0000g000000000000
0000S00000000S000000M000000000
t000000000000000S00000g000000S
00000t0000000000000000g000000S
00000S0g000000000S000000000000
