0g00t00g0000000000000000000000
00000000000000S0000000S0000000
00000000000000S000000000000g0S
0g000000t00000000S0000S00000g0
0000000S0000000000000000000000
0000000S000000000000000t000g00
0000g00000000000t000000000000S
00g000000S0S000000000000000000
000000000000000000S00000S000t0
0g000000000t00g000000000000S00
0S00g000000g00B00000t00B00SBBB
tg0000000000g0B000000000000000
00S0000000000St0000000000000g0
S0S00000000000000gMg000000000M
g000000000000000000000000tg000
0000g00000000t00000000S000g000
000000000g000000S0000S000000g0
0000g000000000t00000000000000S
0g0000000S00000000000000000000
0000g000000000000000S000000000
000S0t0g000000000000000000Sg00
00000000g00t0000000000000000S0
0g00000g00000000t0000000000000
00S0000000000t00000000000000g0
000S0000S000g0t00000000000000M
000g0000000g0t000000B00000S000
t000g000S000000000000000000000
0g00g00000000t0000000000000000
000g00000000000000000tg0000000
S0000g0000000000000000000S0000
