0S0S0M000M0000000T000000000000
S0000000000T00000000S000000000
000000T00000000000000G00000000
0G0000000000000000000000000T00
000000000S00000000GG0000000000
000000000S000000000000000G0000
00000000000000000G00000000000T
000000000000000T00000000000000
0000000000G00S0000000000000000
G00000000000000000000S0T000000
G000S000000000000000000G000000
G0000T00000000000000000G000000
0000S00G00000000S0000000000000
S00000000000000000000G00000000
00S0G000000000000G0000B0000T00
0G0000000T0000000S000000000000
T00000000S0000000000000G000000
0T0G0000000G0B0B00000000000000
0G0000000000000000000T00000000
0000000000G0000000T000000S0000
000000000000T0000G000000000000
0T00000000000000000000000G0000
0000S0000G00000S000000000000G0
0S000000000000000S0000000M000M
00000TS0000SG00000000000000000
000T000000000000S0000000000SM0
00000S0SM0000G0000T0M000M0000G
000000G00000000000S000000000T0
000ST00S0000000GG0000000B00000
000000000000000G0000T0000S0000
