0000000T0000G000000G0000000000
000000000000000000000000T0000S
00000G0T0000000000000000000000
00000000000T00S00S000000M00000
0S00000000000T00000G00000G0000
0000000S00000S000M0G00M0M00000
0000000000000000S0000000T00000
0000000000000000G00000T0000S00
000S0S0000000000000000G00000T0
G00000S0G00000000000S00M0000B0
G00000000000T000000000G000000B
000G000000T00000S00S000G000000
00S000G000000G00000000000S0000
T0000000000S000000000000000000
S000000000000000000000000S0000
0000000S0G00000000000000000000
T000G0000G0B00000000000000000S
000S0T0000000G000000000000S000
000G0000000000S000GBS0B0000M00
S000T00000000000000S000G0GM000
0000000000TS000000000000000000
0000000000000T0000000000000000
000000000000S0000000000000000S
00GG000T000000000000000000000B
S0000000S0000M000T00000000000G
0000000GGS000T0000000000000000
0T000G000000000000000000000G00
0000000000T00000000000S0000G00
00000000G0T00000000G00000000S0
00000000TS0000S000000000G00000
