0000000000gt0000S00g00BB000000
S00000000000000g000t0000000000
0000S00g00t00000000S0000g00M00
000000t000g000000000000g000000
0000000000000000000000000t0000
000000g0000000000000000000t000
000000000000t00000gg0000000000
00000000000000gg00000000000S00
000000gg0000000t000000S000000B
000000000000000000000000000000
00S000t0000000000000000000000g
0t0000g00000000000000000000000
000000000000tS000000S000000000
0t0000000000000000000000000000
000000000000000000000000000000
g0000S000g0Bt00000000000000000
0t000S00g0000g0B00000000000000
00g000000t0000000S00000000g000
0000t000000000S0000000S0000000
00000g000S00000000000000000000
000000000000000000000000000000
000000000000000000g0g000000000
0000000000000g000000000000t000
00g00000t0000000S000000000000g
0000000S0t0000000000000000000g
000S0000tS00000000000MMM000g00
000000000000000000000000000000
0000t0g00000000000000g00000000
000000g00g0000t0000000000SS000
00000000S0S000000000000000000t
