S00T0000G00000000S0G
000G000000T00G000000
000000SS00000G00G000
S0000000000000T00000
0000000T000S00000000
00000000G0G00000S000
00000T000000000GSS00
00000G0000T0G0000000
00T000000000SG00S000
000000S0S00000T00000
S0000TS000000G0000G0
0000000S0T000S000000
000000000S0G0000000G
G0000000S0G000S00000
0T0S000GG00000000000
0000000G00S0G00000T0
000000GT00000G0S00S0
00000T0000G000G0S000
G0S0T000000000000000
T000G0000000G0000000
