00St00S00000000g000g0BB0000000
000000000t0000000000gg00000000
000000000000000g00gB00000000t0
00000000S0S0M000000g0000000000
000g000000000000000g0t00000000
g0000t000000000S0S000000000000
0gS00gS0000B00000t00000M000000
0000S000S00000tM00000000000000
0t00g0000000000000000000000000
0000g000000000000000000000000S
000000000000000000t00000000000
000tg0000000000000000S000S0000
000000000g00000000000000000000
0g0000000000g00000000S0S0t0000
0000000000000000000000g0S00000
000S00t00000g000000000S00000M0
0000t000g000000000gB0000000000
0g0000000000000t00000g00000000
00S00g0000000g000S0000t0000000
000000S0000S000000000000000000
0S0000000g0g00000B000000000000
t000000000000S0000000000000000
S0000S00000g00000000M0000000t0
00000g00000000t00g00000000000B
000000000g00000g00t00000000000
t00Sg0000000000000g00000000000
00Sg000000000t0000000S00M00000
0000000000000000000S0000000000
0000S000000000000000gg00000000
000000000S000g000000000000g000
