00G00000000000000000S00000S000
0000000000000000000000S0000G00
00000000S00G0000T0000000000000
000T0G0000000000000G000000000S
000000SSG00T000000M00000000000
000000000000000000000000G0T000
000G000G0T00000000000000000000
0000G000GB00B0000T000000000000
00000000000000T000000000000000
00000T00000000G000000000000000
000T000000G0000000000000S00000
0000000000000G000GT0B0000000SB
0S000SG00000000T0000000G00000B
0T0000GS0000000000000000000000
0G000000G00000000B000000000000
000000000G00000T000000000GB000
000000T00S000000SM0M0M000G0000
00000000GS00G00000000000000000
000G0000000000SS000000000000T0
G00T0000S000S00000000000000000
0G000G00000000B0T0000000000B00
000T000000G0G000000BS0S0000000
000S00S00000000000000000000000
00000GS00000000000000000G0000T
00000000000G00T00000G000000000
S000T0000G0S00M00000000000000M
G0S0T0000000000000000000000000
000000000T00000G00000000000000
000000000T00000000000S000G0000
000000TS0G00000000000000000000
