G00000000000000000000S00000T00
00000000000000000S00T000G00000
0T00S0000S0000000000000000C000
000000000T000GS000000G00000000
000000000000000G00000S0000T000
0000T0S0000000S00G00000000000G
S0000000000000000000000S0C0000
00000000000000S0000000S0000000
000000000T000000000S00G0000000
000000SS0C00G000000000000000T0
000000T000G00S00000G000H000000
00000G0000000000000000S0000000
000000G00000000000000000000G00
T0000000000000000000G000000000
0T00000SG0000000000S000000000C
S0000G000G000H0000000000000000
0000T000000G000G0H000000000000
0000T00S0000G00000000000G0H000
G000S0T0G000000000000000000000
0T00000000000000000000000000G0
T000000000000000000000S0S00C00
G000000000000G0000000000000000
00T0G000000S00000S000G00000000
000000G0000000000000S000000T00
00000000000000000000T00000000S
000000000000G0000ST00000000000
00000000T000G000000000000G0000
00000000G000T0000000000G00000S
G00000S00T00000000G00HS0000000
000000000G0T00G00S0000S000H000
