0000000G0000T0G000000000000000
00000000000000000000000000000G
000000S0000000000G00T000000S00
000000G00G000T00000000S000S000
00000S000T000SC000000000000000
000000G00000T00000000000000000
00000000000TS000S0000000000000
000000000T000000G00000000S000G
00000000000000G00T0000G0000000
00S000000000000000000000000000
000000000000G0000G000T000H0000
0T0000000000000000000000000000
000G000000000000SSC0000000T000
S000000S0000000000000000000000
G0000S000000000000000S00000000
0G000000G00000000000000000000T
0T000000S0000000000000000000G0
00G000000T00000000S0000000000G
00000ST000000000000000000000G0
000T000G000000000000000000000S
00000S0G0000G0T00H000000000000
000S0S0G0000000000000000000000
000000000S00G00000000T00000000
T00SSC00G00000C0000000000C00G0
00000000000T00000G00000000000G
0G000000T00S0G0000000000000000
00T000G0000000S000000000000000
00G0000000S000T000S00C000000G0
0000000000000000000000000G000T
00000G00000000000000000000000T
