0S0000000SM000000000000M000000
0000St00g0000000S0g00000000000
00t0000000000000S000000000000g
0000000000g00t000000000000g000
000Stg00S000000000000000000000
0t0g000000000000S0000000000000
00000S0000000000000000000t0S00
S0g0Sg00000000000000000000B000
00000t000000g000S0000000000000
00S000000000000000000000000g00
000000S00t00000000000000000000
0000000000g00000000t0000000000
00000000000000000t000gg0000000
t00g00000000000000000000000gB0
000000S00000t000000000000S0000
00000gt00000000000000000g00B00
000t0000000000000g000g000B0000
g000000000S0t00000000000000000
0000000g00000tS000000000000000
SS000000000g000000000000000000
000S000SM000t00000000000000000
000000tg0S00000000000000000S00
00g000000t0000S0000000S0000M00
t0000000000000000000000000000S
000t00000000000S00000SMg0M00M0
t00000000S0000S00Mg00000000000
0S0t00000000000000000g00000000
0000g00t00000000000S00000000g0
0000S000000000000t000000S0000g
000S00000g000t000000000000000g
