0000000000t000000000S00S000000
00000S000000000000000g00000000
Sg00S000g0t0B00000000000000000
SS000tg000000000g0000000000000
0000000000t00000g0000000gS0000
000S000000000000000000t000000g
0000000000000S0000000000000000
00000S00000t000Sgg00B0000000M0
000000000S00000000S00g00000000
g00000000000000000000000000000
0000g00S0t0000Sg00000000000000
0S000000S0000000000M0000000000
000000000000SS0000M00g00g00000
g00000S00S000000t000g000000000
g00000000000000000t00000000000
g0g0000000000000000tB00000S000
0000000000S00000000S0t000g0000
S0000000000000000000000g000000
00t0S0000000000000000000000000
00000000000S00000g00000t000000
00000000000S00t000000g00000000
000000000t0000S0000S00000g0000
000000t00000000000g000g000B000
00S00t0S00000MM000000000000000
00000000t000000000000000000000
000000000t00000000000000000000
g00000gS0t00S00000000000000000
0t0000000000000000000000S0000g
00000000g0g000000000t000000000
0000g00000S0000000000000000000
