0000000T0G0000000000000000G000
000000G000000TG0000000000S000S
0000000000S00000000000000S00T0
S00S0C00GT0000000G000000000000
T0000000S000000000000000000S00
00000S00G00000G000000S00000000
00000S0G00G000000000000000H000
0000T000000000G000000G0000H000
0000S000ST00000000000000000000
0000000000000000000G000000SG00
0S0000S0000000GGT0000000000000
00000SS00T0G0000000000000000G0
000S000S0G00000000T0G000000000
0G0SG00T00000000000H000000000S
000000000000000000S00000T00000
000000G00000000000T0000000000S
000000000TG0000000G00000000000
000000000000000000000000T00000
000000T000000S0000000S00C00000
G0000G00000000000H000000000S00
0S000G00000T000000000000000000
000GS0000S00GC00H0000000000000
00000S0000000T000000000G000000
0000000G00T0000SS000000C0000G0
000000000000000T00G00G0000S000
00000000GS00S0000000000T0C0000
00G000000000000S00000000T00000
00000000GS00000000T000G000000S
00000G000S0000000S000000000000
00G00G00000T0000000S00S0000000
