G0S0000000000T00000S
S0000000000TG00G0000
000S0000G000G0000000
T000G00000000000000G
0000000T00000000000G
0TS00000000000000000
000S00T00000G0000000
00S0000STG0CG0000000
0T000G000G0000000000
00000S0000000000S0C0
00000000G000000T0000
000T0000G0000SG0S000
0000000S0T0G00000000
000000000G0G00000000
0000G0S0SC00000000G0
00000S000000S0000000
00000T000G0000000000
0000G0000G000000000S
0000000000S000000000
00S0000S0T0000000000
