00000T000000G0000000
0G0000000000S000000T
00000000000000000000
0000000S0T0000S00000
000000000GS000000000
00000000T00000000000
S00000G0S000000G0000
00G0S000000T0G000000
00000000000000GT00S0
0000TG0000000S00G000
0000000T000S000000S0
T0000GSG000000000000
000G00G00T0S00000000
00000G0000T000G00S00
S00SG000G00T00000000
000ST000000000000000
0SG0S000000000000000
0S000000000GS0000000
000000T000S000000000
0000000S00000000000S
