000t00g000000S00000000Sg00000B
00000000g0000000000000t0000000
0S000000gg0000B000000000000000
0000000g00000SS0t00000M0000000
0S00000000g000S000000000000000
00000S0000000t0000ggS000000000
t000000000000000000S0000000000
000000000000000000000g0000000S
0t000000000S000000000000000000
00g000S000000000g0000000000000
00000000t00gg00000000B00000000
00000000000t00000000000S00000S
0000t0000000000000000000000000
00000000000000S00000000S000000
000000000000S00000000000g00gS0
0S00t000000000000000S000000M00
00000000000g00000t000000000000
000S00S0tg00000000000000M00000
0t000SS00000000000000Mg0000000
000000000000000t00000000000gS0
0tg000000S00g0SB00000000000000
00000000g000000000000000gB00t0
00000S0tS00000g0g000000M000000
t0S0000000S00000000g0000000000
00tS000000000gS000000000000000
00t0000S0000g0S0M00000000g0000
000g000000000t0000000000000g00
00000000000g0S000S000000000000
S0000S000M000000000000000g0000
000000000000S000000000000000t0
