00000000000000g0000S0000000SM0
t00000000000000000000000000000
00000t00000000000000000000g000
0000S00S0000t0000000000M000000
000000000S00g0t0000000000000g0
0g00S0g000B000000000000SB000B0
0S00000g0000000S0000000tg00000
0000000000000000000000000000S0
000000S000gS00000000M0g000t000
00000000000t0000000000000S0000
00000000000t000000000000000S00
000t0000g00S000000000000000000
000S000tS000000000000000000000
00t00S000000000000000000000000
00000t00000000000000000S0000g0
000000000000000000000tg00S0000
000000000000000000000000Sg00S0
0000000000000000000000000g000S
0000g00000000000S000000t000000
g00000000000000t00000000000000
000000000g0000000000000S0g0000
000000000000000t00000000000000
0gg0t00000S00S000B000000B00000
000g00000000000000S00000000000
000000000000000000S00000000000
0000g0000t0000000000S00g00000S
000000000t000S000g000g00000000
g0000t000000000g00000000000S00
0000000tg00000000000000g00S000
g0000000000000000000000g00000t
