00000000000000T00G000S000S0000
00000000T0000000000000S0000000
00000G000000000000000000000000
000T0000000000000G00G000000000
T000000000000G00000G000000000H
0T000000000000000SS0G000G0H000
00G000000000000T000000S0000000
0000000G0000000000G0000TS00000
S0000000S00000T0000000C0000C00
T0000000G00000S000000000000000
G00G000H00000T00000H00HH000000
00000T00000S000000000000000000
00000000000000T00000000S000000
0000G000000000000G0000000S0000
000T0G00000000000000000SS0000G
0G00000S0000000S0GT00000000000
0000000000T0000000000000000000
0T00S000G000000000000000S00000
000000000000000000S0000000G000
000000000S00000000T00000G000S0
0000G00000000G000H00000000T000
0T0000G00000000000000S000000GH
0S000G0S0000000000000000G00000
0S0000S0000TG00000000000000000
S00000000000S0000000C000GG0HC0
0000T000SS00000000000000000000
0000000000000000000000TG000000
0S00000000T0000000000000000000
000S000000000000T00000S0000000
0S00T000000000000000G000000G00
