0000S0t000000000000000000000S0
00t0000000000000000000000S000g
000000000t00000000000000g00000
000000g0000000000S000000000000
000t00g00000000000S00000000000
0g0000t000g000S000000000000000
000000000t00000000000000000000
00g000000t000000g00000000000S0
0000000000000g00000000000t0000
00g0g0t0000B000000000000000000
00000t000000000000000000000000
000000000000000000000gS00S0M00
0000St0000000000g00000S0000M00
00000000000000000000000000g000
000000S0000000gS000000M000M000
0S0gS00g00M00t000B0000000000M0
00g00000g000t000000000000000B0
000SgS00000g00t00MB000M0000000
00S00000t0000000g000S000000000
0000g0000t00000000000000000000
00000000S0g00000000S0000000t00
00000000tg000S00000S0000000000
0000000000g0000t00000g00000000
0S00000000000000000000000g0t00
00000000000000g00t000000000000
0000t00000g0g000000000S0000000
000000S000000000g0000000000000
000000000000000SS000000000M000
000000000t0000S000000000g00000
000S00000000g000000000000St000
