0T000000G000000000000000000000
G0000T000G00000000000000000000
S0000000000000000S000T00000000
000000T000000000000000000G0000
0000G000000G00000000000000S000
00000S00000000000S0C0000000000
000000000GS000000000000S00T000
00000000000000000000T000000000
00G0000000000000T0G00000000000
000000S0S000000G00GH0000000000
0000T00G0000000000S00000000000
0000T000000000000000G000000000
TG000000000000S000000000000000
0000S000000TS0000000C000000000
0000000GS00000G000000S000C000C
000000G00T00000000000000000000
000G00T00000000000000000000000
T000000000000000G0000S00G000S0
0000000000000G0S0000000000SG00
00T0GS000000000000S0000000C000
0000000G0T0000000000000G000000
00TG0000000G000000H000HH0S0000
000TS000G000000000000000000000
0G0S0G00000T0000H0000000000000
0S0000000000000000SG0000000000
00000S00000T0S000G000000000000
000S0000000000000000000000G000
0000000G0000000000T00000S00000
00S00000000000T00000000000SG00
0000000000000000000S0000000000
