00T000000000000G000000000G0000
00000000000000000T000000000000
0000000000000G00000G00000000S0
00000G0S000000S000T0000000000G
000T00000000000000000000000000
00000000S000000ST000G0G0C00000
0T0000000000S0000000G000000000
000000000000G00000000000000000
00000000S0S000T0000000GG000000
G0000000GHT0000000000000000000
SG0000000TS00000GC0H0000000000
00000000T000000S00000000000000
00000000G000S000T0G0000000H000
00S000G0000G000000000000000000
0G0000000000000000T00000000000
TS0000000000S0000G000C00000000
000G000000T000S0S0000000000000
00000000T000000000000000GGS000
00000T000000000S00000000000000
00SS0000000000000T0000000G0000
00T000000000G00S000000S0000000
000T0000000000000000G000000000
00000G000000000T00000000000000
TG0000000000G000000000000000S0
000T000S00S0000000C00000000000
0T00000000000000000000G0000000
0S00000000000G00S00000C0T0G000
S00000000G000000000000000000G0
00000000T00S0000000000000000G0
000G0000S0000000T0000S00000C00
