0000T000G00000S00000G000000000
00S000000000000S0C00000G000000
S00000000000000T00000SC0000000
00000000000000000T0000000S0000
0000S000000GT000000G0000000000
SS00000000000000000000C0000000
000S000S00C0000000G000T0000000
00000000000S0000T00000S0000000
0T00000000000S0000S00000000000
00000000000000000000SG00000000
0000T00000000000000SS0C0000000
T0G000000000000000000SS0000000
000000000T0000000000000000G000
T00000000000000000000000000000
T0G00000000000GH00000000000S00
00000G00000T00000000G000000000
00S0000T000000000S000C00000000
00000000000T00000000G000000000
0G000000000000S000T00000000000
00000GT0000000000000G000000000
00G00S0000S0000000T0C000000000
00S000000000S000G00000G0000000
00000000G0000000000000000S0000
000G00GH0000000000000S00000000
000SST000000000000000000000000
TG000000000S0000S00G0C00000000
00000000000000000000S0000000G0
0000000000ST00000000SG0000C000
00T00S000000000000000000S00000
G00000T000G00000000000000000S0
