S00g000t00000S0g0000000000M00B
0000000S0000000000000g0g000000
0St0S0000000000000g000M0000000
000S00S00000000000000t00000000
t0000000g00000000000g000000000
00000000gS00g0tBS0000000000000
00000000000000000S0000000S0000
0000tSg0000000000S000000000000
00000000000g00000000g0S00t00B0
00g0t00000000000000000S0000000
t00S00000000000S0000000000000g
0000000000000000000S000000t000
00t00g000000S0000S0000M00000M0
0t0000000g00g0000BS00B00000000
0000000000g00000t00S000gS00000
0000000000000S0g0t0S00M0000000
00t00000000g000S00000000000000
0000000g0000g0000tS00000000000
0t0000000000000S0S000M00000000
t0S00000000000000000SM00M00000
00S00t000000g00000000000000000
S00000000000000000000St0000000
000000000000000000000g00000000
000000000000000000000000g00000
0000000000000000S0t0000000g0S0
0t0000000g000g000000B000000B00
00000t0000000000000S0000000000
00000000000t0g000000g000000000
0000gS000S000gM0000M0000000000
0S000000000000000t00g000000000
