S000000000000000000000gt0000gB
00000000t00g000000000Sg0000000
g000000000t0S00000000000000000
000000St00000S00000g0M00000000
0000000000g0g00000t0000000000B
000000S00000000000g00t000S0M00
00t00000000000000000g00gS00000
00000000000000000g00Sg0000000S
000000000000000000000t00000000
0Sg0t00000000S0000000000000000
00000000000000000000000S000000
000000S00000000t0S00000g000000
0S000g00SM00000t00000000000M00
000t00000000000gS0S00000000000
0S0000g0t0000000000S0000000000
00000S0g0000000S00t0000g000000
0000g0000000000g00000000BB0t00
0000tg00g000000000000S00000000
0000St0000SM00g000000gM000000B
0000000S0000000t000000S0000000
0000S000000t0000000g0g00B00000
000000000000000000t000000000g0
g00000t0000000g000000000000000
0S0S0t00000000000g0000M0000000
000000000000t00000g00g0B000000
0000g0000g0S0t00B00B0S00BB0000
0000000000000000t00gg00S000000
0000000S000t0g0000000000000000
0g00000000000g0B00000000000000
00000t0000Sg0000000S0000000000
