000S00000000TS00C0000000000000
0000000T0000000000000000000000
T00000000000000000000000000000
0S000000GS00G0000H0C0000000000
0SG000T000000000G00S0000000000
00S000S0G000000000000000000000
00G000000000G00000SS0000000C00
GTS00000G00000000S000000000000
0000S0S00000C000000000G0000G00
00000T0000000000000S0S00C00000
00T0S00000000000000000000G0000
0000000GT00S00G000000000000000
S0000G00000G00000000000000T000
S000000000000000S0000000000000
00000000G0GS0000000H000000000S
0000T000000000S000000000000000
00000000S00000000000G0000S0000
T0000000000000G00G000000H00000
0000000000000T0000000000S000S0
0000000S00000S00000G0000000000
0T00000G0000000000000000G0000H
G00000G00000000S00000000HS0C00
00000T000000G00000000000000000
G000000T0S0000S000000000000000
00000T0000G0S000S0000G00000000
00000000S00000000000000S000000
G000000000S0000000000000000000
0GS000ST0000000C000G0000000H00
0G0000000S000G0000000S0000000T
0000S0S00000C0G000000T00000G00
