0000000000000000000000000000G0
00S000000S0M000000MG0000T00000
0000000000S00TS000000G00M00000
000000G00000G0B00000000000S000
0T00000S0000000000S0000M000000
00000000S00S0000T0G00000M00000
T000000G00000000000000000000G0
G00000000000000G00000000B0000S
000000G0S00S000000000000000000
00000000S000G000T00000000000S0
0S00000000G00ST000000M00000000
000000000000000000000S0000T000
GS0G00B000000000000000000T000B
0000000T00000000S0000000SM0000
0T00S0G0000000000GS000B0B00000
00000000S0000G000000T00000G000
00G0000000GBB0T000S0000B000B00
000T00000000S00000000000000000
000T0S00000G000000000000G00000
000000G00000000000000000G0BT00
00T00G000000SSG00000000000000M
000000G000000000000000S0000000
S00S0G00000M0G00M00000T0000000
T0000000000000000000S000000000
000000S0000000T00SMG0000000000
0S0G0TG00BS0000000000000000000
0T00000G000000000000000000000G
00000000T00000G0G00000S0000B00
00000TG00000000000000000000000
S00000000G000000000G0000000000
