T0000000000000000000
0S0000000000000G0000
00G0G000ST0000S00000
00T0S00G0000000G0000
TS0000G000G000S00000
000T000000S00G0000G0
00G000SS0G0000000000
00T00000SG00000SGC00
00G00S00000000T0GS00
00000000G00G000S00T0
S000000T0000G0000S00
T00000S000G0000000G0
0T00000000000S000000
000000S000T000G00000
00000T000S00000S0000
000G0G0S000000T00000
000G0000000000S0000S
0G000T00000000000S00
0000000000STS0000C00
0S0000000000T00S0000
