G000000000G00SS000C0T000000000
00000T00000000000S00SC000000G0
0G0000S0000S000000000T00C0G000
00000000000000000000000000000T
0000000000000000G00G0000000000
000000000000G00GT0000000000000
00GG000T0000000H0S0000000000S0
000TS000G00000000000000000G000
00000000000000000T00000000S000
0G00000000000000T0000000000000
000000000000000000000000000000
000000TSS0000000000000000000G0
000S00000000000000000000000000
G0000000000T000S0G000000000000
000TG0000000000000SGH00S000000
0000S00000ST000000000G00000000
000T0G000000S00S000000000G0000
00000000G000000T00000000G00000
0000000000000T0000000000000000
00G00000000000000000T0S0000000
00000000000000S00000S000C00000
0S0000G0000000SC000000000G0H0H
000000000G00000000000000000000
00G0000000000000T0000000000000
G00S0000000000000S0000000000GC
00000000000000000000T000000000
0000000G000SSG000H00000H000000
0000000T0000000000000000G00000
00000S000000S00T00C00000000000
0000000T0000000000000S0000S0G0
