T0G000000000000G00000000S000S0
00000GT000S00S00000000000M0000
0000000000000000000000G0000000
000S00000000000000000T000000S0
0T0000000S0G00S000000000000000
000G00000000S00T00000000G00000
000000GG0000B0T0000000000B0000
00000000S0S0T00000000000000000
0T0S00000000000000000000000000
00S000000000000000T000G000000G
0SS0000000T000000000M00M000000
00000S000T0000S00G000000000000
000000SG0000G0000000000S0000T0
00000G0G0000000000000000000000
T0000000000G000000G00000000S0S
T000000000000GG0000000000S0000
000000000000000000000000G0T000
000000000000000000000000000000
000S00T00000S00000000000000000
0S00000ST0000000000000000G0000
000000T00G000000000000000G0000
000S00000000000000000000000000
0000S0000000S00000TG0000000000
0000G00G000000B00BS000000000TS
000000GS00G000000000TB00000000
0000000000000000000000000000G0
0000000000000000S00G0000000000
0000S000G000000000T00000000000
0000T0000000GSG000000000000000
000G00G000SB0000TB0000S0000000
