SG00000G0000H00000000000000000
0000000000ST00S0000G0000000000
00TS00000000000000000000000000
00000000000000SS0G000000000000
000000000000000GT00000000000S0
SST00000000G000000000000000000
00000000000T00G000000000S00000
0S0000000000000S00T00000000000
000000000000000000000GT000000S
00000000T0G00000000000S0000000
000S000000G00G0000TS0000H00000
00GG0000S000H00000000000000S00
S0000000000S000000000000000000
S00S00000G00C00000000000000000
0S0000T000000000000000S0C00000
000TG000000000G00H000000S0000S
0G000000S000000000000T00000S00
0000S00000G0000000000000S00000
00000000000S000000S00CT00000G0
00G0000S00000G00000000H0000000
T0000000000S000SC0000000000000
S00S00000CG00T0000000000000000
0000S000000000000000S00T000000
00000T0000000000000000S0000S0C
0S000S00T000000000000G000C0000
0000GST00000000000000000000000
0T00000000G00G000000H00SS0C000
000000000000000000000000S00000
0000000G00000T000000000GH00000
000000T0000GG000000000000000S0
