0000000000000000000000G0S00000
000000000000SS0C0T000000G00000
0000000000S0000000000000T00000
S000T0G00000000000G00000000000
00000000S00000000000S000000000
00000000S0ST000000C000000000G0
0000000TG000000000000000000000
S000G0000000000S000000000000G0
0000S000000T0G0000000000000000
000000TGS0000S0000000000000000
0000S0000T00SG0000000000000000
G0000000G0000H0T000000000000S0
00G00G0T000SS0C0H0000000000000
0000S0G000S0000G00C00000000000
000000000000000000G000000G00T0
00000000000T000000G00000000000
000000T000000000G0000000000000
00000000G00T00000000S00000G00H
00000T000000000000000000G00000
00000S000000000000000000000000
000000000000000G0000000T000000
T0000000G0000000S000000000S000
00000000000S000T000000000S0000
0000000S000ST000000000000000C0
0000000000G00000000T00000SS000
000000000GT0S00GH000000000S000
00000000000S0G00000000000000T0
000T0S00000000000000S00C000000
000S000000000G000000000000G000
00GS0000000S00000000T000000000
