000S0000000000S00G00
00SG0000000000T00000
00G000TS000000000000
0000SG00000000000000
000T00G000000G000000
S000T0G0000000000G00
0000000T000000S00000
0000000G00G00T000000
00S000TG00000000S000
0TSS0G00000000000000
00000000000000000T00
SS0000C00000000000G0
000000S0000000G00G00
000S000T00000000000G
G0000000T000000S0000
0000T00G0000000000S0
S0S00C0000G0T0000000
00G0000000G000000000
0000T000G0G000000000
G0G00000000000000000
