000000000000000000G0000000000T
00000000000000000S0G000T000000
S0000000000G0000000S00000C0000
00G00000000000000000000000S000
0000000000000000G00T0000000000
0000000S0ST0000000000000000000
00G000G000000000000000000000H0
S000000000000000000G0000000G00
S00000000000000000000000000000
0000000000T00S000000S000G00000
000T000G0000G0000000000S000000
0000000G0T00000000000000000000
000000SG000000000000000000T00G
0S00000GG00000000000000000TS00
G0T00000000GS0000000000000H000
000000000000000000G0000G000000
000S0S00000T00000C000000000000
0S00000000S00000C00000000000G0
0000G000G00000000000000000H000
00G0000000000GS0000000T0000000
00000S000T000S0000000000000C00
0000000G0000T000000S0S00000000
0000000000S0000000000G0G000T00
0000000G0000000000000000000000
000000S0000G000000000000S00000
S000000G0S000000000G0000000000
0000000000000000000000GG00SS00
00000000T00G000000S00000000000
0000S00000G0000000G000000000H0
00000T0S00000GS000G00000000H00
