000g00000000000000000000000000
0000000t0000000000000000000000
00000t0000g00000g0000000000000
000SS000000t000000000000000000
g000000000t0000000000000000000
0tg00000000000000g0000B0000000
0000000000000000000000t0000000
0t0000000000000000000000000000
00g000t0000000000000S0000S0000
00t0000000000000S0g00000000000
00S000000S00000000000000000t00
000000000gS000gSt000B000000000
g0000000000000g000000000000S00
0000000t00000000S0000000000S00
t0000000g000S00000000000000000
0000S00g0000000000000000000000
00000000St000g00g00B0S00B00000
0S0gg0B0000000000B000000t00000
0g000t00000000000000000000000g
0000t0000000S00g000g00000000B0
000S0g0000t0000000000000000000
g000000000000000000SS000000000
00g0000000S0000000g00B000000S0
00000000000000000000000t000000
0t000000000g00000000000000g000
000000000g00000000000000000000
0000S0g0000g0S0B00000000000000
0S0gg0B000000000000000000B0B00
0000S0S000g0t000000000Mg000000
00g0000000t0000000000000000000
