00S00000TG0000000000000G000000
0000000000T00000000000000000S0
0T00G0000S00000000G000S0000000
00ST000000000000000000000G0000
0T00000SS000000000000000000000
00000000000000000G00G0000000H0
00T0000000SS0000000000000000C0
0000000G000G000000000000T00000
0SG0000000S0000C000000G0T00000
0000S000000000000000000000GS00
0000000000T00000000000000000G0
00000S00G00000000T0000G00000S0
000000000000G0000000000000T000
000000G0T0000S0G00000000000000
G0000S0S00T0000000G00000000000
000GG0000S000H00T0000S000C0000
0000000000000000S000000G000000
0000000G00000000T0000000G00000
00000000000000000S00000T000S00
00000000S000000000000000000000
0000000000000000000000000000TG
000000000G000000S0G00000000H00
S000000000000000S000T000000000
000000000G0G00000000S0000000T0
00000000000000000G0000000G0000
00T0000000G0000000G00000000000
0000000000G00000T0000000000000
0000T00G00000000G000H0S00S0000
00G0000000000000000T0S00000G00
0000G000000000000000000000GT00
