S0T0000000000000S000
00ST0000000000G00S00
000G0S0S000G00000000
000T0G0000S000000G0S
GST000000000G0000000
G00S0T0000G000000000
G000S0G000T000000000
0000T000000000000G00
00000000T00000000000
S00000000G0000T0G000
00000000S0ST0000G000
0000000S0SG000000T00
000SS0000000000000T0
0000000GGS000000T000
00T00000000000000000
0000000G00G0T00S0000
00GG0000S00000000000
00SS000T0G0000000000
0S000000000T0S0000GG
0ST00000000S0GG00000
