0000000000S000000G00SG00000000
000000G000S0G00000TS000H000C00
0S0T0000G000000G0000H0H0000000
000000000T00000000000000000000
0G0T0000000000G00H000000000000
0000000000G0000000000000000000
00000S00S00000T0G0000000000000
0T0000000S00G00S0000000C000000
S00000000SG0000G0CT00000000000
00T0000000S00000000S0000000000
00000S000000000T00000000000000
000000000T000G00000000000G0S00
G0T000000000G000000000000000S0
0000000S0000000000S000000T0000
S00S0000000000000000000T000000
00000000000GS000T0000000000000
000G0000T0000000000S0000000000
0T00000000000000S0000000000S00
000000G000000000000000000T0000
000T000G000000S000000000000S0G
000000S000000T0000000000000000
000G0000T00000000S000G00H00000
0000000S000S00G0000T0000000000
000000000000000000000000000000
00000S0000000000T000S000000000
000S00000S0000T0000000G0000000
000TS000000000000000000000000S
000000000000000000000G00000000
000000000000000G0000000000S000
0000T0GS0000000000000000000000
