0S000G0S0000000T0000000000C000
S00000000000T00000000000000000
00000000000000S0000000000T0000
0G0000000000000GH0T00000000000
00GS00T0000000000G000000000S00
000T000000G000000000000000G0S0
00000000T0S0000000000000000000
0000G0000000000000T00000000G00
000000G000000000000000000000T0
000000000G000000000G00S0H00000
0GS000G000000000000000000S0T00
0S000S0G0000T00000000000000000
00000G000000000T0G000000000000
00SG0T000000000000000000000000
0000T00S000GG0000000S000000000
000000T00000000S00000000S0G000
0000000GT00G0000000000S0000000
0000S00000S000000CT000G0000000
00T0000000S0000G000S0000000000
000000G0T0000000S0000000000G00
00000000000T00G00000000000S000
00T00S0000000000000000SC000000
000S0000000000000S00000G000000
0000000000G0000G00HS00000S0T00
00S0000S0000000000000T00000000
T0000000000000G0000G0000H00000
000000T000000S0000000000000000
0000S00000000S00G00G0T00C00000
000000T0000000000000S0000G0000
0000ST000000000000000000000000
