S00000000S00000000000000000000
0000T0000000000G0000000GS00H00
00000000000000T0000000000000S0
0S000S0C000000000000000000C00T
00S000G000S0C0C000000T00000000
0000T000000G00000G00000000H000
000S000T0S000G000G000000C00000
0000T000000G000000G0000H000000
00000000000000000000000T000000
0000000000000000000S000T000000
0000T0S00000000000000S00000000
00S00S00G00000000000G000000CH0
0000T000000000G000S0000000S000
0T0G0000000000000000000S000000
000G000000000T0000000000000000
000ST0000000000000G00000000000
000S00G0000000000000G0000S0000
0T00G00000000000000000000G0000
000T00G000000000000000000000G0
0000000G00G0000000T00000000000
00T00000000G00000000S000000000
000S00000000000000000000000G00
G0000SS0T0C00000000000000000G0
S000000000000000G00T0000000000
000000000000000000S00G00T00000
000000SS0000C00000GC0T000G0000
0T00000S0000000000000000S0000C
0G0000000000000G0H0H000TH00000
S00G0000G000000000000000T000S0
00G00T000G000000000S0S0000000C
