0000000000G00G0000000000000000
00000000S00000T000000000000000
000000TG0000000000000000000000
00S00000G00G00000000000S0H0000
0000G00000000000000000G0000000
T000000G000000000000G0H00H0S00
00000S0000000000000G000G00000T
G000000S0000G00000000000000000
00000000000000000000000000000T
000000G00S00000S00000T00000000
0T0000000000000000000000000000
0S0000000000000S0000000000C000
000000000000000000000000T00000
000000T0000000S0S0000000000C00
000000S0S0C0G0000000C000000000
0000000ST000S0000000000000G000
0000T0000000000000000G00000000
0S000000000000000T000G00000000
T00000000000000000000000000000
0000000000000000T000000000S000
0T000000000S00000000000G0S00G0
000S0000T000000000S000G0000000
S00000S0000000C000000C00T00000
0000T000000000000G000S00000000
0G00000S00000000T000000G000000
00000000000000G0T000000000000G
0S000G00000GH00T000H0000000H0S
00000000000000000SS0G0000T0000
000T000000000G0000000G00000000
000000000000G00000000000000000
