0SS0000000T0000000000000000000
0T00000000G000000000000000SG00
0G000000000000G000000000000000
0T0000000000G00000000000000000
000G00000000000T00G00000000000
0T00000000000SG0000000000S0000
00000000000S00GSGT000M0M00000M
S00S0G0000G0000B00B00000T00000
00000000TG000000G0S00S00000B00
000000000000000000000000000T00
0T0000000000000S00000000000S00
000000000000000S0S0000000GT0G0
000S000G000000000000000S000000
G00000000S0000000000GB00000000
T00000000000000000000000000000
0000000S00000000000000GT00G000
0ST00000000000G00000000SM00000
000000T0000000S00000S00000G000
000000000S0T000S0000000000000M
S0G000S0000000000000M00000000G
0000T000S0000S00000G0000000M00
000000000S000000000000000T0000
00000000G000000000000000000G00
00000000000S000G0000000000T000
0000TS00000000000000000G000000
0G000000000000S000000000000000
0000G00G0B0SS000000B00B00000M0
0000000000T00G00000000S0000G00
GS00T0000000000000G00000000000
0000000000T0000000000000000000
