0000000000000t000g000000000000
00000000000000000S0t0000000000
SS0000000000000000000000000M00
0g000000000000t0S0000000000000
00g000000000000t0S000000000000
S0000000t000S0000000000000g000
0gg0000Bt0000S0000B00000000000
000S0tS0000000g0M000000000g000
00t0S000000000000000000000g0S0
00000S0g00000g000000000000000B
000S000000tS0M0000000000000000
0000000t0000000000g00000000000
000000000000S00t000000S00M0000
000g00000t0000g00000000000B000
0t0000S00000000S00000g00000000
00000000000000000t00000g000000
00000000000000000000g000t00000
00000000000S0000000000gS0t0000
t0g00000S00000000000S000000000
0t0000000g00000000000000000000
000000t0000S0g0000000000S00000
g00g000000S0000000000t0SB00000
000t00000000S0000000000S00000g
00S0000000000tS00000000000g000
0000000tgS0000g000000000000000
000tg00000g0000000000000000B00
000t00S0000000000000000g00S000
00000000SS0000000000t000000000
00g000S000000000000000Sg000000
00000000000000St0000g0000S0000
