00S000000000T0000000000000G000
000T00000000000000000000000000
000000000000000000000000000000
00000000S00G00000S0000000000C0
00T0000000000000S0000G00000000
G00000000T0G0SS000000H0000000C
000S000T00000000G0000S00G00H00
00ST00G0000G000000000000000H00
000G00000000000S0S0000GH00000T
S000000G000000G000000000000000
000000000G000000000000G0T00000
0000000S000T00000000G000000000
S00000000000000000000000000000
000SS00G000G0000000C00T0000000
0000000000S0000G00000000000T00
000G0000000G000000T000H0000000
000000000S0000T000000S00000000
0000000000000S00000000G0000000
0000000000T00G000000000G000000
GG0000S000000H0000000T00000000
0000000000T00000000000GG000000
00000T000000S00000000000000000
00000000S0T00000000000000S0000
0T0000000000000000000000000000
0G0000000000000000000S0G000000
000000000000000000000000000000
000000000000000S00000000000000
00000TS00000000000000000000000
0000S0000T0S000G000000C0000000
00T00S0000000000S00C0000GG0000
