00SSM0M00G00000000000000000000
00TS0GS0000000000M00000M000000
0000S000GT0000000000000000G000
0000000000000G00G0000000000000
0G0000000000000000000000000000
00T00G000000000000S000S0000000
00G0000000S00000000T00SM000000
000000000GT0000000000000000000
000000S000T0000000000000000000
000000000000000S0000000000G0G0
0000000000000000000S0000S0G000
0000G000T0S00G0000000000000000
0G0000000T0G0B000S000B00S000B0
00000000S0G0000T000S0000000000
G00000TG00000S00000000000S0000
00000G000000000000000T00G00000
000GT000000S000000000000000000
0G00000000GS0000000000000000B0
00T0000000S00000000000000000G0
00T0GG000000B0S000000S00000000
00000000000T000000000G00000000
00T0000000000000000000000G0000
000000000000S0S000000GT0000000
00000G000000000G0BB0000S00000S
000G00000000000000000000000000
0000T000000000000000000000S000
000000000000000S00T00000000000
00000T0SSMM00000000G00G0000000
00S0000S00TM000000000000M00000
0G0T00000S000000000S0M00000000
