0000000000000000000S0000000000
000000000000000000000000000000
0000TG0S000000000G000000000000
000000000S0T000000000000000000
000000G000S0000000G00000000T0S
0S0000000T0GS00000000000000GC0
0G00000000G0000000000000000000
0000G0000000000000000000000000
0000000000000S0000G00000000000
00S000000000000000000G00000000
T0S0000000000000000000S000000C
S00000000000000000000000000000
000000000TG0000000000000G00000
0000000S00000S000000G0G0000000
000000000000T000S000000000000S
00000000000000GT00000000000000
0G00000T00G000H000000000H000S0
S0G0S000000G000000000000000000
000000000000000000000000000000
0G0000S000000T0000000000G0000H
000000S00000000000000000000G0G
00000000G0000000TG00000000000S
0S0000000000000000000S000G0000
000G00000000000000000000000000
0000G00T000G000000000000S00000
00000000000G00000000G000S0H000
00000000000000000000T00000000S
0000000000G00G0000000S000H0000
000000000000000S000000T0000000
0000000000S0000000000000000000
