0000t0000000000S00S00000000000
0g0000000000000000000000tg0000
000g000g00000000t0000B0000000S
0000S0000g00000S00000000000000
000000g0000t00S000000000000000
00000000000t0000000000g0000000
00St0S0M000M000000gM0000MM000g
00000t000S00000000000000000000
000000S0t00000S00000g000000000
0g000S000000000000t0S0000000gM
00S00000t0000000g0000000000000
00g0St0000000000000g0S00000000
000t00000000000g00000000000000
0000000000000g000000000000000t
00S0000Sg000000000000000t00000
000g00000000000000000000000000
00000000t0SSM00M00000Mg00M0000
0000000g00g0000000000000000000
0000S00000000000t0000000000000
00g000000000000S000000000000SM
0g000000000S0t0000S0000000000g
0000000000000g000000000000tS00
0St000000000000g000000g0000000
00g000000000000S00000000000000
0S000000000S000000000000M0000t
0000000000000000000000000S0000
0000000S00S00000000MM000g0g0t0
S00000000000000000000000000000
0000000t0000000000000SS0g00000
0g000g000S000000S00000000000M0
