00000000GT00000000000000000000
000000000000000G00000G000TH000
00000000000000000000000000000T
00000GS00G0S00000H0T000C000000
000000T000000000000000000G0000
00000S00G0000000SG00000000H000
00000000T000G00000GH0000000000
00000T0000000S0000000000000000
0GS000000ST0G000000000000H0000
0000000000S00000000000000T0000
SSG00C0000000000T000000G000000
0000S000000S000000G00000C00000
000T0000G0G00000H00S0000000000
00000000G000G0000S0000000H00S0
000T0000000000000SGG00000H0000
00T0000000S00S0000000000000000
0000000000000000000000SS000000
00S000000S0000000000T000000000
0S000000G0000SCT00000000G00000
S00000000000000000GT0000000000
0000S0G00000ST000000000000000G
000000T00000000S00000000000000
000000S000T0000000000000000000
0G0000000G0000000T000000000S00
SGT000000G00000000S00000000000
00000000S0000T000000G000000000
0000TSS0000000G0000GC0H0000000
000000000000000000000000000000
000000000000S0000000000S0C00G0
000000000000S00G0000000000000S
