000g00St0S00000000M0M000000g00
0tS000000000gS0000000000000g0M
000000t0000000000000g000000000
0000000g0St00000000g00B0000000
S00000000000t00000S0g00M0000g0
000000000000000000S000000000g0
0000S0000000000000000g0000S00g
00t0000g0000000000000000000000
0000000S00000000000000S0000000
g00t000g0000SS0000000000000B00
0g000000000gt00000000000000000
00t0S0S000000000g0000000000000
000000000000g000000S0000000000
0g000000SS0000000000000t000000
0t0000000000000000000000000g0g
00tg00000000000g0000000B000S00
000000000g000gB0Bt000000000000
g0000000t0000000g0000S000S0000
0000000000Sg00000000000000000t
S00000000000SM00000000000t0000
000000S0000000000000000000g000
000000000000000g00000000g000tS
000S000000t0000000000000000000
00000000g00t0000000000000000Sg
000t000000g00000000000000g0000
0000000SS0000g0000000000000t00
00t00000000000000g000000S00000
000000t0000000g0000g000000S000
S000000000000000g00000000000S0
g000000S00S0000000000000000g00
