0000000G00S000000G000000000000
0000GT0GHS00S000000000000C0000
0000S000000000G0000000S0TC0000
0000000S000000G000000000000S00
00S0T00000000S0000G00000000000
0S000000000000S0GC00000000000G
0S0000T000000000G000000000G0H0
0000000000000T0000G000000G0000
000000000000SS000000000000G0G0
000S00T0000000G00000S00000C000
00G0000T00000000000S0000000000
00000000000S0000000S0000000000
0S000G00S0000000000000000000C0
00000000G00GH0S000S0000T000000
000000T00S0000000000G000000000
000T0000S00000000S00C000000G00
000000000T000000000000000000GG
0000G0000000T0000000S000S00000
000T00000000000000000000000000
G00T00000000000000000S00G00000
00S00000000G00000000T00000G000
0S00000G000000000000000T000000
0000T0000S0S00GC00000G00000000
000T000000000000S0S0G00C000000
0000S0000S00000000000000T00000
000T000000SGS0C000000000000000
0S00000S00T000G000000G0000C000
00S00000000T000000000000000000
00T0G00S0S00000000G0C000000000
00000000000000000000000000T000
