000T000G0000000000S000000000S0
000G0000G0000H000T000000000000
000000000000000G0000000T000G00
000GS00000000S00000000GH0000T0
T00G0G0H000000000000000000S0S0
0000000000TG00000G0H0000000000
000000000000000000000T00000000
0000G000000000000000G0S0000000
000000000T00000000000000G00G00
0000000000000000T00000G0000000
0G000000000000G000000H00S0000S
00S0000T0G00S00000000000C00000
0000000S00000000000000000000T0
GT00000000S0000000000000000000
T00000000000000000000G00G00000
000000000000S00000000000000GSG
0000000000000000000TS000000000
T00000000000000000S00G00000000
0000000T000000S000000000000000
00000000000000G000S000G0000000
00000S0000T0G0000000000000G000
STG0000000000000S0000000000000
00S000G0000G000000000000000000
T00000000S00000000000S000GC000
000000000G0G0000000000000H000S
0000000000000S0000S00000000000
0S0000G0000000T000G00000000000
0000000000S000000000000000T0G0
0T000000000000S000000000000G00
00T00000000G00S0000000000000G0
