S00000000000G000S0000000T00000
0000000000000000000000000G0G00
0000000000T0000000000000000000
000000000000S0000000000000S000
G00000000000000000000000S0G000
0T00000000000000000000000G0000
S00S00000G00000000000000000000
000G000000G000000T000000000000
000S00000000000000000000000000
00000000T000000000GG0S00H000S0
000T000000000000S00S0000000000
000000T000000000S00S0000000000
000000000000T0000000000000S00S
00000000T000000000000000000000
000000000000000000T0000G000000
000G0000000000S00000000000S0C0
00T0000S0000000000000000000000
00000000000000000S000000000000
00G0S00000000000000000T0000000
000000000000000000S0S0C0000T00
00000000000000000000G0000000G0
G00000G0S0T0000H0000000000000S
00000SG00TG000000000S00000C000
000000G00000S000000000000S0000
00T00000000000000000000S000000
00000G000000T00000000000000000
000000T00GS00GH000000000000000
00000000000000000000G000000000
S000G0000000000000000000000000
000000T00000000000000000000000
