000000G0G0H000T00000S000000000
00T000000000000000000000000000
0000T0000000000000000000G00000
000000000000000000000GG0000000
0000S0000000000000000000T00000
0G000S000T0S0000000G00000H0C00
000000000000000000STG00000000G
00000000000T000000000000000G00
0000G000S0000000000S00000G0000
0000T000000000S00000000000000G
00000T000000S00000000000000000
000000T000S0000000G00000000000
0000GS000T000000G000000H000000
000000S0ST00G0C00G000H00000000
G000000S0S00000T00000000000000
00S0S00T00G0000000000000000000
000G000000G000H00000000T000000
0S00T000000000000000SC0G000000
00000000000000ST0000000S000C00
TGS0000000000000000000000G0000
00000T00G0000G0000S00S00H00000
00000000000000S000000000000000
00T00000000S000000000000000G00
0GT00000S0000000G0000000000H00
T0SGG0000000000000000000000H00
000000T0S000G000000SG0H0C00000
00000S00SC00000000T00000000000
000000G0000000000T000000S00000
00000000000000000000T000000000
00T000000000000000S00000000000
