0TGG00000000S0000000
000SG00000000000S00T
T0G000S0S0G000000000
00000TSSG00000000G00
00000000000S0T00000G
0S00000G00000000S0G0
0000000000GS00000000
00S00000G00T00000000
00000000000000000T00
00T00000000000000S00
0000S00000S0G0000000
T0000G000G0000000000
000G000T0000000G0000
TG00000000000S000000
00000000T00S000000SG
0000S0G000000T0000G0
0GG000000T00000S0000
T000G000G00000000000
0000000TG00S0000GS00
0G00G0000S0T00000000
