000000000000000G0S000000000000
T000000000000000000000S000000G
00T00000000000000000G000000000
000S0000000000000000S0T0000000
0000000000000T00G0000000000000
G0000000000T0000G000000000000S
S0000S0000C000T00000000G00G000
G000000000G00S00S0C00000000000
000000000000000000000S0000000S
00S00G00G0T00000000S0C000H0000
T0000000000S000G0000S000000000
0000000000000000000000S0000000
0S000000000T0000000SC000000000
00000000000S00000G0000S0000C00
0000000000000000S0T00000000000
00G0000000000000000000SS0000T0
00G00000S0S0T0G0000C0000000000
00G00000000G000000000000000000
000S000000000G000000000000T000
00000000000000000T000000000000
G00000000000000000000000T00000
0G000000S000S00000G000000000T0
000000G000000000000000S0000T00
000000000000000000000S00000000
00G000G000T00000SS000H0000C000
G00S0G00H000000000000000S00000
0S000T0SG0C0000000000000000000
00000T00000S000000G00000000000
00000TG00G00H00000000S00000000
0000G0S0S00000000000000G000000
