SS00000T00000000000MM000000000
0000G0S000000000000000GT0S0000
0000000000000S0GG00000000B0000
S00000G000G00000B00B000T000000
000GG0000T00S0000000000000000S
0000000GS000000T00000000000000
0000G00ST00000000000G000000000
0T000000000000000G0000G0000000
000000000000T00000000000000000
000S0000GG000B0S0B000000000000
000T0S00S000000000000000000000
T000S000000000G00000000000G000
SG000T00G0000000000000S000M000
T00000000000GS000000000G000000
000000000000T00000000000000000
0000G0T0G000000000000000000000
GT00000G0000000000000000000000
GT0000000000G000B0000000000000
00T000000G00000G00000000B00S00
0000000000000S0GS000GT00000000
00000000000000000T00000S000000
0SS00GM0T000000G0000000000000M
0000T00S0000000000G00000000000
00S00000000T0000G0000000000000
0000000000000000000GS000000000
00SG00000000000000000G00T00000
000T0000000000000000000G000000
0S000T000000000000000000000000
S0000000000000S00G000000G00M00
0000T000000000SS000MG000000000
