T00000000000000S00S00000C00000
000000000S0000000000000G00S00C
000000T0G0S000000000000000S000
0000T0000000000000000000000000
000000GT0000G00000000000000000
00000000S0000G0000000T00000000
000000T0000000000000S000000000
00ST000000S00000000000000G0000
0GG0000T00000S00S000H000000000
000000000G0000000000000S000T00
000000G000T000000000000000000S
000000000G000GT0000000H0000000
T000000000000000000000G0000000
000000TS0GG0000000000000000000
0S00000000000000T000000000000S
00S000000T00000000000S00000G00
000000000T000000G00G0000S00H00
000G000000000S0000000000G00000
T0G000S00G00000S0000000H000000
0000S00000000000000G000000GT00
TS0000000000000000000000000000
0000S000000S0000000000C00T0000
0000000TS0000000000000S000000C
000000000G00000T0000000000000G
GS000GH0TS00000000000000000000
000000T0000000G00000000000S000
0000S000000000T0000000G0S00000
0000000000000000000G0000000000
000T000S00000000000000S0000000
0000000000000000G00000000000T0
