000000000SS00000G00000000000T0
000ST000000S00000G00000000000C
T0S00000000S000000000000000000
000000G0000000000000S000000000
0000000G00T0SS0000000000000000
00000000000000GT00000000000000
00000G00S0000000000T000000G0H0
SS000000C0G000T00000000G000000
0S0000000T000000000000000000G0
0000T00000000G0SG0000000000000
T000000000000000000000000000S0
00000000G000000000T00000S0G000
000000G000T0000000000000000000
00G0G00000HST00000000000000000
00TS00000000000000000S000G00G0
000000000S0T000000000000000000
000000SS0000C00000000000000000
G0000000000000000S00000T000000
000000000000000000T0S000000000
0S00S000G000000000000000000000
0000000000T00000000000000G0000
S0S00C0000000000000000000T0000
00000000T0000000000000S000G000
0000000000000000000S0000000000
00G000000000000000000000S00000
00T00000000000S0000000S0000C00
00G0T0000000000000000G00000000
0000000000T000000000S000000000
000G0T000000000000000G0000H000
0000S00000000000000000000S0000
