0000T0G00000000000GS
000000000000000GG000
SGG000000S00T0000000
0000S00000000S000000
00G0T00G000000S00000
0G0000T0000000000000
00G00000TG0000000000
0000G0S0TG000S000000
0000S00000000T000000
0T0000000G00000000G0
000S00T00000S0000000
G000000G000000000000
0000G0T0000000000000
S0000000000000TG0GS0
00S000000000T000S000
00G0000TG00S00000S00
S00T000000G000000000
0000000GG000000S0000
S000000S0000T00000G0
0G000000SG00S0000000
