000S0T0000000000G0S0
00000000000G00G000S0
00000G0S000G0T000000
00000G000T0000000000
00000SG00000S0000000
0000G0000000G0000000
0000000000SGG00000S0
S0000S0000000G000000
00S0G0T000000S000000
TS0000G00000S000000G
T000000000000000000S
000000S00000000T000G
0000SS000000G0G00000
0000000STG000000000G
0T00000000G000000000
00000000000000000G0G
00000S00G00000000G00
0000T000G0000G000000
0GT00000000G0000S000
000G000G00000T000000
