0000000g00000g0S00000000000000
00000S00S0g0M00t00000000000000
000000000S0g00000000t000000000
0t00S00S0000000000M000M00000g0
0000g000000000000000S00000S000
000S0000000000t00S00000M000000
000000000000000000t0g00000000S
00000000000t000000000000000S00
000S0t000000000000000000000000
000000000000000000000t00000g00
0000000g0000000000000000000000
0t0000000g0000S000Sg00000B00B0
00g000S0000000000t000S000000g0
00000000g00000000000000000g000
00000g00000000t0000S0000000000
0S0S0000000000000000000g000000
0000000000000000000S0t0000000g
000000Sg0S00t0000000000000M000
00g00t000000000000S000000g0000
0000S000000000000S0M000g000000
0tg0g0000B000000S0000000S00000
000000gS0g00000000B000B000B000
0000S0S000000000000000000000M0
0000t0000000000000000000000000
S000t00g00S000M000000M0M00000B
000000000000000g000g0000000t0B
tS0000S00g0000000000000000M000
S0000000tSM0000000g00000M00000
0ggB00S0t0000000S00000000MB000
000S0000000t0000000000000000S0
