0000000G000000G00B000000000S00
00000000000S0000000000T000G000
0000000000G000GT00000000S00000
S00GG00B0000BS0000B00000000000
00T0G0000000S00000000000000000
00T000000S00000000000000000000
0S00000G00000000ST000000G0MM0M
000000000S000000000000000GTG00
0T0000S00000S00000000000000G00
00S0000000000000T00000000000SM
000G000000G00000B00B0000S00000
G0000T00S00G00B0000000000000B0
00G00T0000000000000000S0000000
0T000000000000G000S00000000GB0
000000S0000000T00G000S00000000
00S0000T000000000000000000S000
000000G000000G00B0000T00000000
S00000000S0G00000000000000000G
000T000000000SS000000000000000
0000000000000000000S000000T000
00000T00000000S00000S000000000
S00G0000000000T000000000000000
00000000000G000000000000000000
G00T00000000G00000000000000000
0000000T0000000000000000000000
0G0S0S0000000000M0G00000000MM0
0GT000000000000000000000000000
00000T00S00000000000000000G000
0S000000G0T00G0000000000000000
0000000000000000SSG00000000000
