000000000SS0T00C00000G0000G000
00000T00000000000S0000G0000000
000000S0T0000000S0000G00000000
0000000000T000000000S00000000G
000G0000000T00S000000000000000
00S000000000S0000000000000C000
0G00000000000G000000000000T000
00000000000S0T0000000000000000
00T0000000SS000000000C000000G0
0000000000000000000000000000S0
0T00000000000000000000000G0000
00000000000000000000000T00000S
00000000000S00000000000000000S
000000000T00000000000000000000
0S0G000000000000T000000S000000
0T0S000S00C0000000000000000000
000T0000000000000000000G000000
0G000G0000000000000S0000T0000H
000000G000000000000S000G00T000
000S000000000000000000000T0000
0000S000000000G000000000000000
0000000000SS00000000000T000000
0G00000000000000000000T0000000
000S000000G0000000000000T0G000
G0000G0SH000000000000S0000C0T0
000G00S00000000000000000T0000G
00000S00000000S000000000000000
00G0G0000S0000000000T000000000
00000000S000G000000000000G0000
0000000000T0000G00000000000000
