0G0G0000S00000000S0M0000000000
0000S0000000000000000000000G00
00000000S00000000T0000G000G000
G000000000000000000000G000S0BB
000000000S000000000T0000000000
00G000000000000G00000000000000
G000000000S00S000000T000000G00
000000000000000000000000000000
00000000000000S000G00000G00000
0000000000000000000G000G000000
000000000GG000000000000T000000
0000000000000000S00T0G00000000
00000000000000000000T000000000
S00000S000000000000000000GT000
T00S00000S00000000000000000M00
S0000S00T0000M000M000000000000
0000000000000S00S00000T0M00000
0G0000S0S00000T000000000000000
0T00000000000000S0000000S00000
00000S00000000000S000000G0T000
00000GT00000000S00S0G0000B0000
G00000000ST000000G000000000S00
000000000000T00000000G00000000
00G0G00000B000B00B000B00000000
000000T0000000S00G000000G00000
000000000S0000000000000G000T00
0T00000000000000S00000000S0M00
000000S00000000S00000000000000
0000000000SS00TMG000000G000000
00S000T0000000000000S0000G0000
