G0000T00G000000000S0
00000000T0000SGS000G
G0000T000000G0000S0S
0T00000000G00000SGS0
00T00SG00000S000G000
00ST0S00000000000000
T00G0000000S00S00000
0000T000G00000000000
00S0T000000000000000
0T000000000G00000000
0SG0T00000000000000G
00G0000G0T0000000000
000000S0S00000T0G000
0G0S000GT00S00000000
00T0000000000000S0G0
0T00000S0S000G000000
00GT0000000000000000
000000000T0000000000
00000000SG0000S00000
00S000G000000000000S
