00000t000000000gS00000000g0000
0000t0g00S00000000000000000000
000000000g0S00000t000000gS0000
0000g0000tS0000000000000000g00
0S0000S000000000M0000000M00000
0000S0000000t0000000gg00000000
00S0000000000000000S00M000M00M
S00000000g0S0000g000000B000000
0t000000000000000000000000S000
0g0t00000000000000000000000000
0000g0000000S00000000g00B00000
0g0S0000000000000000000S000M0g
00g0g00000000S00t0000000000B00
0000g000000000000000g000000000
00000t000000g000000000000000S0
0S000000000000000t0000000g0000
00tS0000000S0000M00g00g000000M
0t0000000000000000000000000000
000000000000000t00000000000000
0g0000000000000000000t00g000SS
000000000g00000t000000g0000000
g0000t0000000000000000S0000S00
000S000000S00gt00g000000000000
g00gS0000000S0000000000M0000B0
t00000000000000S000g000000000S
t000000000ggB000000BS00B00SM00
000000g00S00000SM0000g00000000
00000000000t00000000S000000000
000000000000000t00000000000000
00000g0t0000000000S0000000g000
