000G0000000000S000000000T00000
00000000000T000G00000000000000
0000000000000T00000SG0S0000G0H
00000T0000G00S0000000000000000
00000000G000000000000000G00SH0
SG00GS000000H00000CT0000000000
000000T0000G00000000000S000000
G000G00000000000000000000H0000
0S000TG00000000000000000000000
00T00000000S00S000C00000000000
000000G0000G0000T00S0000000000
0T00G0000000000S000000000000SG
00T0G00000000000000S0S00000000
G0000000000G000000HT00000S0S00
ST00000G0000000000G000H0000000
00000000G00TG0000S000000H00000
000000G00000000G00000000000000
G0G000000000000000000H00000000
T00000000000000000000000000000
00000000000TS0G000000G00000000
00000000000S00G00000T000000000
000000000000000000000000000000
000000T000000G000000000G000000
0000S00000T000GS000000C0000000
0000G0000000000000000000000000
0TS00000S0000C0000000000000G00
0000T0000S0000000000000000S000
00000S0G0000000000000000000T00
0S00G00000000SC00000T000000000
ST00000000000000G000G000000000
