00000000000000000000000000S00t
000000t0000000000000000S000000
00000t0S0000000000000000000000
00SS0000000000g00000M0g00M0000
0g0g0tS000B0000000000000000000
0000000g0000t00000000000000000
0000000t0000000S000S000000M0M0
0000000000g0g0000000000S0B0t00
00000g000g000B0000000000000S00
000000g0000t000000gS0B00000000
0000000000gS0t000S00000M000000
0g00t00g0S00000000000000B00000
0g0000tg000000000000000SB00000
S0000000S0M000tM00000000000000
00000000000000tS0000000g000000
g0000000g000S000000000000t0000
0000000000g0000000000000000gB0
0000000000000S0000000g0000000g
0SS00000000000000000g000000Mg0
00000000g000000S0000t00000g00S
0000g000g0S00000B0t000B0000000
S000t0000000000000000000S00000
0000t000S000000000000000000000
000g0t0000000g0000000000000000
000S000000000S0000000M000t0000
t000000g000000gB0S000000000000
00S00000000t000000000000000000
00S00000000000t000000000000000
00g0S0S00M00000000M0000000M000
000g000t000S000000000000S00000
