0S0GG000000T0S000000
0G00000000G000000000
0000000T00G000000GS0
0T000000000000000000
SSC00000T00000000000
000000000000T0G00000
00S0000S00G0G0000000
00000000000G00G00000
000000TG000000000000
00000000TS000000G000
0000S0G000000GT00000
0S00T00000000G000000
00000000000000000000
00T0000S000000000000
000T0000G0000000000G
00S00000000000000000
00GT0000000000000000
00000T00000000G00000
0000000000GG0T000000
0GSG0000000000000T00
