StS000000000g000000M0000000000
0000000S00000000000g00000g0000
000t00000000000g000000000000g0
0000g0000000000g000S0000tB000S
00000t0000000g0000g00000000000
0000000t00g00000000000S000g000
0000g00000t00gS0000000SM000000
000000tS0000000000000000g000S0
000t0g00000S000S00000000000000
0000000S000t00000S00g0g0000000
tgg000S00000000000000000000S00
00000000000g00000g0000B00000S0
0gg0000000000000S0000000000000
0g000000000000g00B00B0S0000000
000000t00000000g0000000S000000
0000t0000000000000000S000g0g00
0g000000000S0000t000S000000000
000000000S0000000S00000000000t
0000g0000000000S0000SM00000000
000000S000000000000S000t00000M
000S00000000g000000000g00000t0
0t0000000S000000000g00SM00g000
0000000t000000S0g000000000000g
00000000000000000000S000000000
gt00000000000000000000g0000000
0000000000000tgg00000000000000
0000000000000St0000S0000000000
000000S00000000000000000S00000
0000000t0000000000000g0S000000
00S0000000000g000000St00000000
