00G000GS000000000000
000S0000000G0000S0T0
00000T000000G000000S
00S000000S00C0G00000
0000ST00000000000000
00000000G0000000T000
0S00G0000S00C0G00000
00T000S00S0000G00C00
0000T00000000GSS0G00
T0000000000000000000
000G00000000SS00T000
S00000TG000S000C0000
000000000000GS000000
S00000GS000000000000
000000T0000S000G0000
00000000000000000000
0T00SG00000G00000000
S0000S0000000T0000C0
00000000000000000000
0000SG000T00000G0000
