000G000GS0T000000000H000000000
00000000000000000T00000SS00000
00G00000000000000000G000000S00
0000000S0000S000000T0000G0G000
000000T0G0000G000H000S000000S0
00000000000G000000S000000000G0
000000000000000S0000S00T000000
000G000000S000T0S0C00000000000
0000000000000000000G000000000G
0000000T0000000000000000000000
000SG0T00000000000G0000000000H
000000S0S0C00000000T00G0000000
0S0000000000S000G0000T00G0000H
0G00GT0000S0000000000000H00000
000000G00S0000TG00S00H00000000
0000000S00000G0000000000000000
000T0G000000000000000000G00000
00000000000000G0000S000000000T
0000000SG0S0C000T000000000GH00
0000000000S0T0000000SC00000000
T0G000G000000000S00000000000H0
000000000GS000S00C0000000T0000
0G000G00000000000S0T0000000000
G00SG00H000000SC00000000000000
00000000S000000000000000000000
00000000000T0000G00000000S0000
0000S000000000000T00G000000G0H
000000000000000000000000000000
000T0000SGG0000000000000000000
0000T00000000000000S00000G0000
