0000000000000000G0G0000TSH0S00
GT00000GS00S0000C000H000000000
0000000T0000000000000000000000
G0T00000000000G000000000000H00
0000000000ST0G00GS00000000H000
S00000000000T00S00000G00000000
0000S000S00C000000000000000000
0000000000000000000000000T0S00
000000000000SG000SG00000000000
00000S0G0T0000000S0000000G0000
00000000G0000000000T000S0GS000
00G00000000000000G000000000000
0000S0000000S000000G0000000000
GTG0000000000000000S000H000000
00S00000000T000000G000G0000000
0000000000G00000S0000S0GH0T000
00000T000000000000000000000000
00G0000000S00000T0000000000000
00000G0000S00000T0000000G00000
000S0000000G0000000000000000T0
0000000000000000000T0G00S00000
S0000000T00000000G00G000000000
000000000T000000000000000G0000
000G00000000000000000000000000
00000000000000000000G00G0000H0
0000S00S0T0000C000000000000000
00000G00000G000000000S00000000
G0000000000000G000T000SS0000H0
00G0000000000000S0000000000T00
00T00000000000000000G000000000
