000G0GT0HH00000000000000000000
00000000000SGTS00G00C00C000H00
00000000S00000G00G000000000000
G00000S00000000000000000000000
0000T000G00000000G000000000000
00000TG00000000S00G000000H0000
00G0000000000G0000000000000000
ST00000000000000000000000000S0
00000G000000000GTSH00000000000
00G000S00000000000000000S00000
S0000000T00000000G0000S000G000
000000000000000000T000000G0000
000T000000000S0000000000000000
0T000G00000000000G0H0000000000
000000000000000GG0000SH0000000
00T000000000000S000S0000000000
T00000000000000000000000000000
00000000S000T00000000000000000
00G0G000000H000000S00H00H00000
00000000SG0000S00000000C000000
S00000000000TS0000000000000000
S000G00000000T00G0000000000000
0S0ST000C0C0000G0C000000000000
000000000000T00000000000000000
00T00S000000000000000000G0S000
0000S00000T0000000000000000000
000T00000000000000G00000000000
00000000000000000000S000000000
0000G00000G0H00000T0H000000000
0000000S0000000T000000000000S0
