GT00G000000000000B000000000000
00S000000000000000000000000000
00000G0G000000000000000000B000
00000000G000000000000T00000000
000G00000000000000000000000ST0
00000000S0000000T0000000000000
000000000000000000000000000000
00000T000S000S0000000000000000
000000S00000000000000000000000
000000000000T00000000000000000
000000000000GGB0TB000B000S0000
000000S0T000000000000000000000
00000000000000000000000T000000
000000000T00000000000S0000000S
000000000T00000000000000000000
T0000000000G00G00S00000000000S
00T0000000000000S0GS0000000M00
0000000000000T0G0000000S000000
000000S0000TS00000000000000000
0T00S00000S0000000000000000000
T000000000S00S000G000000000000
0000000T0000G000G0000000000000
0000000000000S00000S00M0000000
000S00S00000000000000000G00000
0T00000000000G00S0000S0000M000
000000000000000000GG000000000B
0000000000000S000G000000000000
0000G00000000000000000000T0000
000ST000000000000000G00G0000B0
00000000S000000G00000000000000
