0G0T00000000000000G000000000B0
000000000000S00T00000000000000
GS0G00000S00000T000000M0000000
00T00S0000000000000G0000G00000
00G0000000000GT00000BS00000000
T0000000S0G0000S00000000000M00
00S00000T00000000000000000S000
0T00000000S0000000000000000000
S000000S0000000G00000000000000
000000T000000S0G000G0000000000
000G00000S000G000B00S000T0B000
GTS00S0000000000000000000000G0
00T00000000000G0000000S0000000
00000T000S000000000000G0000000
00000000000000000000000000000S
0G0000S0000G000S0000T000000000
0000T0000000000000000000000000
00000000T000G000000000S00G0000
00TG0000000000000000S0000S0000
0000G000G0000000000000S0T00000
00000000000T0000000000000000S0
S00000000GGB00S000M000000000M0
000G000000000000S0000T00000000
000S000000000G00000000S0000000
T00000S00000G0000000000S00M0M0
000000000T000000000000000S0000
TGS000000000000000000000000000
0000000000T00000G0S00000000000
T0000G000000000S00000000000000
000000000S000G0G00000B00000000
