0t00000000S00000g0000000000000
00000t000000000000000000000000
0S0000000g000000000000000t0000
0S00000000000g0000000000t0g000
0000000S00000000S0000t00000g00
0t0000Sg00000000000000SM000000
S00S000M0g0g00t0000000B00B0000
00S0000000gtg000S0B0000B0000M0
000000t0000000000S000000g00000
00000000000t0000000000000000S0
000000000t00000000000000000000
000t0000Sg000000000g000000B000
00Sg0000t0000S0000M000g0000B0B
00000000t000000000000000g00000
0t0000S00000000000000g000g0000
0Sg0g0000000000000000000000000
0000000000tSg00000000000000000
t00g00000000000S0g000000000000
0000000000000000000000t000g000
000000000000000S000t0000000000
0000000t0000000000000S00000000
g00000000S00000S0000000000000t
0000SS00000000g000000M00000000
00000000000000g0g0000000000000
00t00000000000S000000000g00000
0g000000g000000000B00000000000
S0000000t00000000g0000g0000000
0000t0S0000S000000000g0M000000
0000000000g0g0S000000t00000S00
t00000000000000000000000000000
