0S0000000TSG000000000000000000
0T0000000000000000000000000000
000T00G00000000000S00S00C00000
00S000T000GG000000000000000000
0G00T0G0000000S0000000000S0000
G00000000S0G000000000S0000000T
000000000T0000000G000000000G00
000000G0000S0000SC0000000000G0
0000000000000000GT0000000S0000
000G000000G00000000000000000S0
0S00000000000T000000000S0000G0
0S0000000T0000GG0000000S000000
00T00000000000000G0000000S0000
00000G00000G0S0000000000000000
00000G0T00G0000000S00H00000000
000000000T0000000000000000000G
00000S000000000000000000000000
0000000000T00000000GG000000000
T0G00000000000000G0000000SS000
0G000000G00S000000H00000000000
000000000000000000000000000000
00S000T00000000S00000000000000
000000000T0000S000G00000000000
00000G00000000000000000T000000
0T000G000000000000G00000000000
00000000G00T00G00SH00000000000
00000S00000G000000T0G0000000H0
00S00000000000G00000000S0000G0
000000G00000T00000000000000000
0T0000S0000000SC00000000GG0H00
