0000000000000000T0000000000000
0T0000000000G00000G00000S00000
0T0G00000S0S0000G000B0B0B00000
0G000000000000000000T0S000000G
00GS0T000000000000S00M00000000
000000000000S0T00G00000000S000
0000G000000S0G000T000B00000000
000000000000000000S00000000G00
0S000G00000000000000S00000000G
00G0000000S0S00M0000TG0M0000B0
00T000000000S0000000GG000000S0
0G00000000000000000000000000G0
000000000000G000T0000000000000
0S00000T0000000000000000000000
000000T00000000000000S000S0MM0
TG000G0000000000000S000000S000
000G00000S00000000000000000T00
0000TS0000000000000G0000000000
000000000000S00000G00000000000
0000G00T000000000000S000000000
000000S000000000S0000000000000
000000G00000GB000000T00000000S
000TG00000000000000G0000000000
G00000000000000000000000000000
00000000T00G000000000S00000000
000000000000000000000000000000
0G00000000000G000000S00S000000
0G000000000000G0T00000000000B0
0T00000000000S0S0000000MG00000
T0000S00000000S0000000000G0000
