0000T00000000000000000000S000S
00T0000000000G0S0000G000S00000
000TS00000G000G000000H00000000
000000G000S000S000000000000000
G0000000G0T00H000000000000000S
0000S0T0000000000000000G000000
00TG00000000S00000GSH000000000
S0000000T000000000G00000G000SC
0000000G0000S00000000000S00C00
00T0000000000000000000000G0000
000G0SG00000000000000000000000
000000000000ST000000S0C0000000
000000000000000000000000000S00
S000000G00000000000S00GH000000
T0000G0000000000G00S00H0000000
0000G000000000000000000000GTS0
000000000GS0000G000S0000T0H000
G000000000000000T0000000000000
000000000000G0000000S000000000
00000000000000T00G00000S0000S0
000000G000S00000000T0000000000
0000000S00S00G0000000CT0000000
G000000000000000T000000S000000
S0000000000T00000000000000000G
TG0000S00000G0000S000000000000
00S0000G0G000T0SH0000000000000
000000000S00000000000000000G0T
00000000S000000000S00000000000
G00000000000T000000G00000000S0
000S0T00000000000G000000000000
