T00000S0000000000000
00S00S0000TG00000000
G000S00000000ST00000
0000000000000000G000
00000T0G0000000S0000
00000000000000S0G000
S00000000000S0000000
G00S000S000T00000000
0T0000000000000000G0
0S000000G0000T000000
0000000000000000G000
00S00000000T00G000SC
000ST00S000000000000
T000000000SGG0000000
0000SG000G0S00000000
GS000G0000000T000000
0S0000000000000S0000
000000000G0000000000
0G0ST0G000S000000000
0TS00000000000S00G00
