00G000000000000000000G00000000
000000SS0T00000CG00000000000G0
T00000000000000000S0000S00000G
000000T000000G0S0G000H00S00H00
000T000G00S000S000000000000000
0000000000000000000S0000000000
00S00000T0SC00C000000000000000
000T000G00000000000000S000S000
000000000000TS0000000000000000
0000000000T000000000G000000000
T00G000000000G0000000H000000SH
000T000000000000000G000000000G
0000S000000S000000000T00000000
T00000000000S0GG0H0000H0000000
0000S0T000000000000000000000SG
0000000000G000000000S0SC0C0000
0G000000T000S00000000000000000
000000000000000000T000S0000000
0G00000000S0GS000000000C0C0000
000000000000T0000000000000G000
00000ST00000000000000S00000000
T00000S00G000G00000000000000H0
000T000000000000S0S0000000C00C
0000000000S000SG00000000CC00T0
0G00000T000000S000000000S00000
0000G000S000S000000G000T000000
00000G000S000000000S00TC000000
00G00000000000000T000000000000
T0000000000S00000S0G0000000000
S000000000000000T0000G00000000
