00G00G0TS00S00000000
0000000G000000000000
0000G000000000S0000S
00000000000000000000
00G0000T0000000000G0
GT0000S0S00000000000
S000000000S00000000T
0000S0ST00000000G000
00SG00000000G0T00000
SG00000000S00G00T000
00GGT0000000000S0S00
G0000G0000000S0S0000
000000GGS00000000000
0T000000000000S0S000
00T0S00000S000000000
T00G0000000000000000
000G0000T00000000SS0
00SS00000000000G0000
0S0000000S0000000000
00G0S000000000000000
