0t0000g00000000000g0000B0000BS
0000000000000g0000000000g00000
000g000000000t000000000000000g
00000000Sg0gt00000000000000000
00000000g0g00000SS0000MB0B0000
00000000t000S000000000S0M00000
000000000000000000000000000000
00000000gS00000S00000M00000000
0000S0000000000000000000000000
00000000S00000000000S000000000
00t000000000000000S00000000000
000S00000000000000Sg0t0M00000g
00000000S00000S00000000t000000
000000000000000tS000000000000S
t00000000000g0000000g000000000
0S0g0t000000000000S00000000000
00000000000000000000t000000000
g0g0000000B0t000000000000S0000
S000000000000gg000000Bt000BS00
000000000000t000000000SS000g00
0000g0000000t0000000000000000S
00t0000000000000000000g0000000
0gg00000000000000000B00S00B000
0000S000000000000000000000000g
0000t00000000000S0g00000000000
00000g0000000000g0000000000000
0000000000t00000000SS000000000
S0S0000t00MM00000000M0000g0000
0000000000000000000S0t000g0000
00SS00000000t0000000M000000000
