000000000000000000000000G0S000
0000G0000000000G00000000000000
00000000S00000000G0000G0H00000
000000000000000000000000GTG000
0S00000000T0000000000000000000
00000000000000000GT00000000000
000000000000000000000000000000
0SG00000000000TSC0000000000000
000G0000000SGH0000000000000000
00000S00000000000000000000000S
0000000T00000000000000000G0000
00000000000T000SG0G0000S00C000
00000000000000000000G00000G0HS
0G000G0000000S00000000000H0T00
00000S00G0T0000000000000000000
0S0000G000000000G0000000H0T000
0000G000000000T000000000000000
000000G0T00000000S0000000GH000
0000000000T0000000000G00000000
000G000000G0000000000000HT0000
00000T000000000000S00000S0G000
00000G0000S000G0000S00H0000000
S00000000G000T00000000G0000000
000000G00000000000G000000S000H
000G00000S00G00000000000000H00
000T00000G00000000000000000000
0000000G00000T00000G0SH000000S
00SG00000000SG0000000C00H00000
00000T00000S00000S000000C00000
00000GSG000000000000H000000000
