000T00S00G0000000G0S0000000000
000G000000000000000000000G0000
0000000000S0000T000GS000000000
0000000SG00S000T00000000000000
000000000S00000T00000000000000
S000T0000000000000000000000000
0S0000ST0000C00GG0000000000H00
000T000000000S00000000000G0000
00000000000000000000000000000S
00000000000G000000000000000S00
0000000000000T0000000S00000000
00T000G00000000000000000000000
00000000S00000000000GG000S0000
00T0SS0000000G0000000000000000
00000G000000G00H0T000000000000
000T000000G00000000G0000000000
0000000000000000000000000000S0
0000T000000S000000000000000000
G0000TG00000000000S00H00000000
0T0000000S0000000000000S000000
000G00000000000000000G00000000
S000G0000000000G00000T000000H0
000000T0000000000000G000000S00
0G00000000000G0000000000000000
00G00G000H00000S00S00C00000000
00000ST000000000000000000G0G00
G0000000S00T00S000000000000000
00T00000G00000S0000S000000G000
00000000S0T0000000000000000000
00000T0000000000000000000S0000
