0000000G00000000000S0000000000
0S0000000000000T0000000000000G
00T000G00000000000G00000000000
00S000S00000000000000000000T00
0000000G00000S0SG0TM0000B00000
0000000000000000G00G0000T00000
T00G00000000G0000000000B000B00
0000000000G00000T0000000000G00
00000000000G00000T000000000000
000000T0000000G00000S000000000
000S00S0G000000000000000000000
000G000000G0000000000000000000
0000S00000000000000000G0000000
0000000000S000000000G000000000
00000000000G00000T000000000000
000SG0000000T000000S0000M00000
0S000000000000000T000000000000
S00000000000G000T0000000000000
0000000000S00000TS00000MG00000
S0T000000G00000000000000000000
000000000000G000000GB000000000
00SG00T00000GB00S0000000BBB000
000000S00S0000000MT00000000000
00000000S0000000S00000000G0000
0000T000000000000000000000S000
00000000T00000000000000G0S0000
000000G00TG0S00000000000000000
0G0000G000000000000000T0000000
000000000000000000T000000000G0
000G00T0G000000000000S00000000
