000000000T000S000000
0000TS0000000000SG00
S000T0000000000S0000
0S0000000000000000S0
SST0000G00000G000000
0000T00S0G0000000000
00S00000000000000000
000000T000000SG00S00
T0000SS00000000G0000
00000T00000000000000
000000G000000S00S0G0
00000000000000SST000
000000G0G0T000000000
00G00000T0S0000000G0
00T0SS00000000000000
0S0000G0ST0000000000
000000TG000G00000000
0000000000000000T0G0
00G0S00000T0S0000000
000S00000000S0T00000
