S0000S0T000C00000000
S000000G0000S0000T00
0GG0000T00000S00000S
000000000GS0S00000G0
000S00TS0G0G00000000
0T000000000000000000
0000000000T00S0S0G00
00000000000000000000
S000000000000000S000
00G0000000000000G0ST
00000000S00000S000G0
000000000000000000T0
00000T000000000G0000
0000000G00000S000S00
T0000000000G00G00000
000000000000000000G0
000T0000G00G0S0S00C0
000000000T000000S000
T00000S0G0000000S000
00000GGT000S00000S00
