0000S0G00000000000000000000000
G000G00000S00000000S0000B00000
00SGG00000000T0000000000000000
0TS0S000000000000000M000000000
T000000000000G0000000000000G00
00T0000000000G000G000S00000000
000S0000G0000000000000G0000B00
000GG000S00000S000000000000000
000000T0S000000000000G00000000
0000S000T000S0000000G000000000
S0000000000T0000000000000000S0
ST0000000G00S00G00000M00000000
000S00000000000T00000000000000
0G000000000000000G000B0S000000
00T00000000000G000000SS00000G0
0000G000000G0000000B0000000000
00G0S0000000000000G00000000T00
00000S0000000T000000G000GB0000
000S0T000000000000S00000000000
0000000000000000S00S00MM000000
0000000000000G00T000000S000000
00T0000G00000000G0000000000000
000T00000000G000000000000000G0
0000S000GGB00S000000T000000000
000G000000G0B0T0000S0000000000
G00000000G0000T0SBS00000000000
000000000000000SGS00000000000M
0GT0000000000000000S0000000000
0000000000000000000000SGG0S000
000000T00000000000000000000000
