000SS000T00C00000G000000000000
0000G00G00000000T0H00S00000H00
0000000000T00000000000S0000000
0S0S000000T0000000000000000000
00000G0S0000T00000000000000000
0G0T0000GH0000000000000SSH0000
00T0000000S00000000G000000000G
0000000000G000000000G0000SS0T0
S0000000000T000G0S0G00000H0000
00000G000000000000T00000000000
0G0G0S0T0S00000C00C0H00000H000
T00000000000000000G0000S0GS00H
000000000000T0000000000S000000
0G000000T00000000000000000000G
0S0000000T00000000000G00S0G000
S00000S00T000000000000000C0000
TG000000000S000000000000000000
G000000S000000000000G00SCH000C
0000000000000000000000S000000S
S0000000S00000000G00000000T000
000000T00000G00000000000000000
00000T0000S0G00000000000000000
00000G00S0000000GS0C0000000000
0000000000ST0000000000G0000000
00S00S000000000000000T00000C00
0000000000S000000000000T0G0000
0000000000G0ST00000000G0000000
000000T00000000S000000000000GG
000000000000000000000000000000
000SS000CC0000000TG00G00000000
