G00000000GS00H0000000000000S0T
0000000GG000S00000000H00000000
G000000S00000T0000S00000000000
000T000SG00000000000S0000C0G00
0SG000000G00000000S0C000000000
000T00S00000000000S00000G00000
0000000000000000G0G0000T000000
00000000000S000T0000000S00G000
0000000T00000000000000000S0000
G0S0T00000000000000000S0000C00
000G00T000000S00000000000000S0
00TG0000000SS00000000000000000
000000000000S0TG0000000000S000
G00S00000G0S000HT000000C000000
00000000T000S00000G0000000000S
000000000ST000000000S0000000C0
0000000000G00000000000TS000G00
0000000000000T000G000000000000
0000000000000000G0000000000T00
0000000000S0000000000000T00000
000000000000S00000000G000G000T
000000S0000000G000000000T000S0
00000G000000000T0G0000000H0S00
00000000000T000000000000000000
00000000000S000T000GS000000000
00000000000S000000000000000000
0GG0000000T00H00000S0000000000
000000G0000000000000000TS00000
0S000000000000T00000G00000G000
00000T00000000G000000S00000000
