00S00S0M00000000000000000M000M
0000000000000000000S0000000000
0G000T000000G000S0000000S0000M
0G00S000000000000000000000G0T0
T000000000000000000000000000G0
000T00000000000000G000S0000000
00T0000S000G000000000G00000000
0000000G000000000000000000G000
00S0000000S0000GG000B000000T00
000T00000000000000000G000000S0
00G0000000000000000G000B000000
000000T0000000000000S000000000
000000G000T000000000G00B000B00
0S00SM00000000G000000000000000
0000000G0S0S0000000T000M000000
00000G0000TG00000000S000000000
000TG00G00B0000000000000000000
0000000000000000T0000000000S00
000T00000000S00000000000000000
G000000S0S000M0T00000000000000
00000S000000000G000000T0S0M000
00000000G00000000T000000G0000B
0T0000000S000000S00G0000G00000
000000T00000000000000000000000
00S0000000000000000S000TM0G000
000T000000G0SS0000000G0000MM00
0000000000000000S000TS000G0000
0T0000G000000000000000G0000000
0000TG00000000S0000000G0000000
00000000000000000G0000GB000000
