0000000S0000000G0000G000T00000
00000000000S00S00000C0C00000T0
0000GS000000000T0000000000S000
0SS00000C000T0C00000000C000C0G
T00000000000S000000000000S000C
000T000000000000S00000000S0000
00000000T000000000G000000G00S0
000000000000000000T000000G0S00
000000G0000000T00S0000000S0000
S00000000S0000000CT00000000000
0T0000000000000000S00G00000000
000S00000000S0T000000000000000
0T0000000000000GG000H0000S00H0
00000000000G00000000000000S000
000TSS0000000000C00C0000000000
00000000000T000000G00000000S00
0T00000000S0G0000000000000G000
000000000000000S00GG0H00000000
000000000G000S000TS00000000G00
0000000G00G00T0000S00S00000000
S000G00000000G0000T000S00C0000
0000000000G000000000GS0T000000
0000000000000T0000000000000000
000GGHH00000T00000000000000000
0000000000000T0000000000G00000
000000T0000000000G000000000000
0T00000000000000000000G0000000
0SGSG00000000T000000000H000000
0G00000000000T0000000000000000
0T0000000000000000000000000000
