00000T0000000S0000S0
000000S00T0G0000000G
GG000000000000S00000
0000000G000T00000000
000SG00000000000S000
00GGT000000000000000
G00000S0T000SG000000
00000000000000G0T000
000T0SSG000000000000
G000000T000000000000
GS0S000T000000000000
00S00T00000000S00000
S000T000G00000000000
0000000T00000S000000
T000000S00S0000G000G
000S00000000000000G0
0000000000TS00000000
000G000T00SG0S000000
0T0000G0000S0S0G0000
0000000000000000S000
