TS0000G0S000000000C0
00000000000000000000
000000000T0000000000
00000T000S0000G0G000
00S00000000G0T000000
0G000000000S00000000
0000000000S00T000G00
00000000000000000000
00T000000G0000000S0G
0TG0S0G0000000S000C0
S00GS00CT00000G00000
0G0TG00000000000000S
000S00000S0T000C0000
00000T00S00000000000
T00GG00000000S000000
0T00000S0000GG00SC00
000000000G00G00000T0
0000000000000G0000S0
T0S0000000S00C000000
000000G000000S000000
