0T000000S000000000000000000000
T0GG000000000S000000000S000000
0000000000000T0000S000G0000000
0000000000G0T0000000G00000000H
000G0000000000T00000S000000000
0T0000000000000S000000G0000S00
00000G0000G000000000H0000H0000
0T00000000000000S0S000000C000C
0000S000000S00T0000000C0000000
0000S0G000000S000000000000000T
000ST00000000S00000000C0000000
00TG000000000000000S000G000000
T00000000000000000SG00S0000C0G
00000000T000000000000000000S00
00000S0000000000000000000TG000
0000000000S0000G0S00000000000T
G0S0000000000S000000000000000G
00000000000000G0000000S00000SG
000000T00000000000000000000000
000000000T00000000000000000000
00S0000000G00000000000S0000000
0000S0000T000G00000000G0H0000H
00G0000000000000000000000G0000
0000T0000000000000000000000000
00000000T000000000000000000000
G00000000000000000G000000000TS
000000TG000G00H0000H00H00S0000
00T0000000S0000000000000S00000
T000000000S0S0000C00C000000000
00S0000000000T0G0000G000000000
