0SG0000T00000000G000
T00G000000SS00000000
00G00000000000T0S000
G00000TSG0S00000C000
0000000000000S000G0S
0S0S0G0000000000G000
00000S000000T0000000
000000000000T0000000
000T0S0S0000000G0000
0000GT000S0G00000000
00000TG0000000000000
0000T00S00000000000S
00S00000000S000GCT00
0T000G00000000000000
000000000T00S000G000
00000000000000S00GT0
0000000000ST00000000
00000000000T00000000
00S0G000S0000000G000
T00G00000000000000G0
