0000g000000g0000000t0000000000
000000000g00000S0g0000S00M00t0
00000000000000S000000S0M0t000M
0000000000g00S0S00t00000g00000
000000000000000S000000000S0000
000t00000000000S00000g00000000
00000t000S0000S000000000M00000
0000t00000S00000S0000000000000
000000000t0S00000000000000g000
00t000000000000000000000000S00
000000000000000000000t000000S0
0S0000000000000000000000000000
0000g0g0000B00000000BS00S00000
S000000000000000S000t00000000M
000000g0000000g0000000000t0000
00000S000000000000000gS0000000
00S00000gtg0B0000000B0B0000000
000t00000000000000000000000000
0g0S0000S000MM0000000000000000
00g00000t00g0000000000000000B0
000S0000S000M00000000Mt0000000
t0000000000000S000000S000g0000
000Sg0000S0t000M000g00000000BB
00S00S000000000M000M0000000g00
g000000000000000g00000000t0000
00000000000gSS00000M000000000g
0000000t000000S0000S0000g00000
00t00g0000000S00000000000S0M00
00g0000000g0B0000000B000000000
00000000gt00000000000000000000
