S00S0G000000C00000000000000T0G
00T000000000000000000000000000
000000000000000000000000G0000T
00T00000S000000000000000000000
000S0T0000000000000S00G0000000
000000G00000000000S00000000T00
0T00000000000000000000G0000G0H
000000T00000000000000000000000
000T0000G000000000000000000G00
S0000000S0000C0T00000000000000
00000S000000000000000000G00S00
000000000000TS0000000000000000
S00S000000000000000GCT00000000
G0000T000000000000000000000S00
0000S0T00000000000000000S00000
G0T0000000S000000000000S000000
000000000T000000SG00S0G0C00000
0000000000000G000000TS000G0000
0000000000G0000000000000000000
000000T0000000000000000000000S
0000000000000000000G000000000T
00000000T00000S000000000000G00
000000000000000000S0G000T00000
0SG000000T0000000000000000S000
000000000000000000S0S000000000
0000000T0G0000000000S000000000
0000G0000000000000000000000000
0S000ST000000000G000000000000G
000000000G000TS000000000000000
GT00S00000000S0000000000000000
