000G00TS00G000000000B0000000B0
00000000000000000T0GS00S0000G0
000000000000000000000000000000
000000000000000000000000000000
0S0G000000T00000000SM000M00000
0000000000000SG000T000000G0000
00000000G000000S000G000S0000T0
00000000TS00000000000000000000
00000G0000000000000T0S0G000000
000000000000000000000000000000
0000G0000000000000000000000T00
T00000S0000S0000G0000000000000
00000000000000000T00000G000000
0G000000000TS00000000000000S00
0000T000000000000GS00S00000000
000T000000SG0G00S000000M000000
000000000000000000T00000000000
000000000000000000G000000S0000
000000000000000000G000000000S0
0000000000G000ST0SGB0000000000
00G000S00S0000000000000T000000
00000SS000000G0000M0000M000000
00000000000T00S000000000000000
00T000S0000000S00000000M000000
0000SSM000M00000T0000000000000
00000T0000000S0000000S000M0M00
00000S00000G0000T0000000000000
0000000G0000000000G000000000B0
000S000000000000000000S0000000
GT0G0B0B0000000000000B00B0B0B0
