00000000000T000000000000G0GS00
0000000G000000000S00S000000000
0000000000000000000T0000000000
00000G00000G00000000ST0000S00M
000000T0S00000000S000000000000
00TG000G000000S000000000000B00
0000G0000T00000G00000000000000
TG00000000000000S000000S0000G0
00000G0G0000T00000000S000B0000
000000000G0G00S0T0000000000000
000G0S00000G000000B0000BT00B00
00000G00000000000000000000S0G0
0000000000000000000S0000000000
000000000000000000000000000T0S
00GS00000000000000S0T00G000000
000000G0G0000T0B00000000000000
00000000000S0000T000000000S000
0000G0GT0000000B0B00000000000S
00000T0000000GG0000000S0000000
00S000S00T00000000000000000000
0000G000S00000000S0T0000000000
00000000000S000000000000000GS0
00000000G0000G0000000000T00000
0G00T00000000000G00B0000000BS0
00000000G000SG0000000000000000
0000S0000G00000T0000000000G000
00000000S000T00000000000000000
00S0T0S00000000000000000000000
0000000000000T0000000S000000G0
0000S0000S0000G000000000000000
