S00000S00000000000000000000t00
00000000tS000000g000S0g0000000
00000t0S00S00g00000000M0g00000
0000St00S000000000000000000000
000t000S0000000000000000000000
000g00000000000000000000S00000
0000t00000000g0000000000000000
00g00t0S000000000g00B000000000
000S00g0000t000g0000000000B000
g0000000g0S000000B00S000000t00
00S00S0000t000000000000000000M
00000tg000000S0S00000000000000
0000000000S0t000000000000000g0
0000000gg00B00B00B000000000t00
000000g00000000t00g000000BS00B
000t000000g0000000000000000000
000000000000000St00S0000000000
000t000000g000000g000000000000
000000000000g0g00B00000000S000
00g00t00000000000000000S000000
00g00000tg0000B0000SB000BB0B00
t00000000000000000g00000000000
00g0S00g000000000000B000B0t000
000000t00000000g00000000000g00
000000000000g00000St00g0000000
00S000000000000S0000t000000000
0000000000t000000000000S00S00M
00t0000000000000SS000000000000
00000000000000tg00000000000000
000S000000000000000000tg00gS00
