T0000000000000S0S000
GG00T000S00000000000
G000G0000T0000000000
0GT0000000000S000000
0000000000T000000000
T000S000000000000000
S0S000000000T000G000
0S0000000G00S0000000
0000000SG0000000T00G
0000T000G00000SG0000
0000000G000G00000000
0SGS000000T000000000
00T00S00000S00000000
00000G0S00000G0ST000
0000T000000000000000
00GG0S00000000000000
000G0T00000000000000
00G000S00G0000000000
000S0000000000000000
000000S0S000000000G0
