00G000G00000S0T00000
00S00000000G00000000
S0000GTS00000C0000G0
0STS00G000G000000000
0000000000000000T0G0
00S00000000S00C00000
00T0S000000000000G00
0S00000000T000000S00
G000000S000000000000
GSS000C0G0T000000000
00T0G000000000G00000
00ST0000000000000000
00G000000000T0000000
0S00000G00000000T000
0G000T000000G0000000
T00S0000G0000GS00000
000T000G00S0000G0000
000000G0000000T00000
00000T00000000S000S0
0GS000000S000000G0C0
