0000000000GG000000000000S00000
0000STS0000000000000G000000G00
00000G0G00000000S0000B0000T00B
00000000000TG00000000000000000
0G000S0000S00000000000000000MG
00000G0S00GT00000000BS0000MB00
0G0S000000SG0000000000TBM00MM0
000000000GG000B000000TB0B0B000
00T0000000000000000000000000G0
0000000S00000G00TS0GB000000000
0000000T00G00000000000000000G0
0TG00G00000000000000BS0000000S
0S0000000000T000000S0000000000
00000S00G000S0000000000000MG00
000000S00T0000000S000000000000
000000T000000000000000000G0S00
0S0000G000T0G0S00B0M0000000000
000000G0T00000G000000000000000
00T000000000000000000000000000
000000G000000000000T0000000000
0000T0000000000000000000000000
00000G000000G000000SB000000000
000000000000000G00000S000000G0
0S000000000T000000000000000000
000T000000S00000000000S0000000
000S000000G0000G0B000000T00000
S000G0000G000000S00000000000B0
SS000000000000000000T0G0000000
000S0000S0000000000000G0000000
0000G0000000000S00000000000000
