0S0000G00000S00C0T000000000000
0000000000000000000000000000S0
00000SS0G00000T000000C000C0000
00000000000000S0T00S0000000000
0000TSG00000S00000000000000000
00T000S00000000000000000000000
0000T0000G00000000000G0000000S
G00000000S000S00000T000000000C
0000000000000000T000000S00S000
T00S0000000000000G00S000000000
000000G00S000GT000H00000000000
00000T000000S00000000000000000
000000000T00000000000000000000
0000000000000000G00000000S0G00
0T0000000G00000000000000000000
000000000000000000000T0G000000
00000T000000000000000000000S00
0000GT00G0H0H000000000H0000000
000000000000000000000000000000
0S0G0SC000000CGH000000C0000000
0T00G000000000000G000000000000
00T000SS0000C00000C0000000000G
00000TG0000000000000000000S000
00T0S0000000000000000S00000C00
00000000T0000000000000S0000000
000T000000S0000000G00000000000
0T00000S0000S00000000000000000
0S000000000000000000000S00000G
0000T0S0000000000GS0000GC00000
T000000000000000000000000S000G
