0S0g000t0000000000000000S00000
0000000gg000000000000000000000
t00000000000000000000000000000
00000000000000000000g000g00000
00t00000000S00000g000000000000
00000000S0S0000000000000000000
0t00000000000000000000000g0000
000000000000g000g00t0000000000
000000000t00000000S0g0000000Sg
000tS00000000000g00000S0000000
0g0000t00000000000000000000000
t000000000000000S0000000000000
S000000g00000000St000000000g0B
0000000t00000000000S0g000000S0
0000000000t000000000S00S000000
00t00000000S000000000g00000000
0t0000000S00000000000000000000
0g00000000000000000t0000000000
0000000g000000g0t00B0000000000
00000tg000000g000000S000SM0000
0tg0g0000000000000000000000000
0S000000gS0000000MM000M00M000t
000g0000t0000S0000000000000000
0000000000S00000S000t000000000
0000tg000000000000000000g0000S
0000000000000000000000000000S0
0000000St0S0000000000000000000
00t0000000g00000000g0000000S00
000g0000000000S0000S000t00g000
000S00000000000000000000000000
