00G00000S0000000TS000000000000
00000000000G000000T00000000000
S00000000000000000000S0T000C00
0000000000000T000000000000000S
0000000S0000T0000GS00000000000
0S00000G0G000000HS000000000000
0000S00000T0000000000000000000
000G00000G000000000T0000000S00
0000000000000T0G000000000000S0
0G0G000T00000000S00000S000C000
T00000000000000000000000000000
000S00S0G000G000000H0000000000
00000000T00000000000000S000000
00000000000000000G0000000S000G
T000000000000S0000000000000000
G000000000000000000000000000T0
S0G00000000000000T000000000000
0000000000000000S0000000SC0000
00000000000000SS0000000000000G
00S0000000T000000S000C00000000
0000000T0000000000000000000S00
G0000TS00000000000000000000000
00S00S000000000TC0000000000000
T00000000G000000G00000000000H0
000000T000S000S00C00GG00000000
T00000000000000000000000000000
0000000S000G000000000000000000
000S0G0000000000000000ST000000
00000000000000000000000000S0S0
0000T0G0000G0000SH000000000000
