0000G0000000G00000000000SS0000
S000000000000T000G00000000S000
00000G0T000S000000S00000000000
00000000000G0000000S0000000S00
000000000000000000000000000000
00T00000000000000000G00000000S
000000000000000000000000000S00
0T0G0000G00S000000000000000000
G00T0000000000000G000000B00000
G00000000000000G0000T000000000
GG0000000000B00T00000000000000
000000GS0000000S0000000GM0M0T0
0000000S000ST0M000000000000000
G0000T0000S0000000000000000000
0T000000000000000G0000G00B0BS0
T0G0000000SS00000000000000000G
S0T000000000000000000000000000
000000TG000000000G00S000000000
0T000000000000000000S00000G000
SG0000000000000000000G00000B0B
000S00G00000T000000000000S0000
00000000000T000000000000000000
0000000000000000000000000T0000
000000000000000000T00000000000
00000G000000000000000000000G0B
00000000000G000000000000T00000
0000G000000000G000000000000000
000000000000000S00T00000000000
000000S000000000000000G0T00S00
00000000000T00S0000000000G0000
