00000000000000G00G00000000000S
0000T000000000000000G00S000000
00000000000SS00000000000000C00
GSG000000000000000000ST000H000
G0G0000T00000H0000000000H00S00
GS00000000000000000000000G0000
000000000000000000S0000S000GC0
00000S0000000000000000G0000000
0000G0000000000000000000T00000
0000000000000G0000000000000000
000000000000000000000000000000
S00T00000000000000000G0000S000
000000000T0G00000S000000000000
000000000000S0T000000000000000
00000000000000T000000G00000000
00000000000000000G00G0000T0000
SS00C0000000T000000000000C0G00
0000000000T00000000S000000000G
0000T0000G0000000000000000G000
0S0000000000T0000000000000000S
0000S00T000000000G000000000G0S
000S00S000000000GG0000000000C0
000S00000T000000000S0C00000000
0000000ST00G0S00000000C0000000
00000000000000000S0000T0000000
000T00G000000000G0000000000000
000G00T0GH0S0000000000H0000000
00000000000000000T00000SG00000
00000000000000T0G0000000000000
00G00000000000S0000000000G0000
