000T0G00000000000000000S00G0S0
0000SG0000T0000000000000000000
0000T000000G000000000000000000
000000000000000000000000TG0000
00T0S0000G000000000000000G0000
G000000T0000G00000H0000000S000
00000G0000000T000000000000S00G
0G000S0T000000000000000000G00H
0000000000000T00000S0000000000
0000000000000G00000000000S0000
0000000S000000S00C000000000000
000S0S0000000000000G0000000000
0000T0000GS0SGH000000000000000
STG000000000000000000000000S00
00S0000S0000000C00G00000000000
000000000000000000000000S00000
G000000000G0T00000H00000000S00
0G0000000000T000000G0H00000000
00000000000000G000T00000000000
00000SS000000C00000T0000G00G00
00000S000000000000000000000000
00T000000000000G00000000000000
0000000000000000S0S0000000000C
000T0000S00000G000000S0000C000
000000T00000SS00000C0000000000
000000T00000000000000000000000
00000000000000T000G00000000000
0T0G00000S000000000000000S0000
0000000000000000G00S000000G000
000T00000000G000000000000S0000
