000000S0000000TS0000
0TG00000000G00000000
0000T000000000000000
00000GTG000S00000S00
00000G000T000000S00G
000G000S000000000G00
00000000000S000T0000
000000G000T000000000
T0000000000000000000
0T00000000000S000SGG
0S00000S000GT0G00000
000S0000T0G00G000000
S000GT000000S0C00G00
00000000T00S00G0G000
00000000000GG0000000
000G0T0000SS0G000000
0000TG0S000000000000
G00G0000000000000000
0000000S0000S00G0000
00000S0SGG00T0000000
