00000000000ST000000G
00000GS0T00000000000
00T0S00G000S00G000C0
G0000T00S00000000000
000G0000000T0000SG00
00000TS0000000000000
00T0000S000000SGG000
000000S000000000000S
0ST00000S00000000000
0G000TG0S00000000000
00000SG0G00000000T00
000000000000000T00S0
00000S00T00S0C000000
T000000000000000000G
S00SG000000000000000
000000000G0000STS000
0T00G000000G00000000
0GSG00000T0000000S00
000G00S000000T000000
0G00000T000G00000000
