0000g0g00000000000000000t00000
0000g000S00000S000000000000000
S0000000000t000S00000g000MM0M0
0g0000000000000S000S0000000000
000g00000000000000t0g000000000
00t000g00000000000000000000000
g00000000000000000000S00000000
0000g000000000000000000000t00g
0000000S000000t0000000S0000000
0000g00t0000000000000g00000B0S
000000000000SS00g0g00000000000
000000000000S000ggt00000S00000
000000000S0t00g000000000000000
tSg0000000000000g0S0000000B000
SSM0000t00M0000000000000000000
00000t000000000000000000000000
g000000000000gB0000S00000000t0
00S000000000000000000g000000t0
0000000000000000S00000g0g00000
0000000S0000000000000000000000
0000000000000t00000000gS0000S0
g0g0000t000000B000000000000000
00gg0000000000000SS0B000000000
00000t0000S00000gS0000000000g0
0000Sg00S000000000000000000000
00000t00000000gS0000g000S00000
g00000000000000000000000S00000
000g00000000t00000000000000000
00000000000t000000000000000000
g00000t00000g00000000B0S0B0S00
