000000000000000000S00T00000000
G0000000T0000G000000000000H000
000000000T0S000000000S00000000
00S0000000000000000000T00000G0
00000G0GS000H0000000000000000H
0S00G00000000000G0000H0000H00H
0000S0000000000000G000000S0000
00000G00000T00000S000000000000
0000T0G000S000S00000G000000000
G00000000000000000000000000000
00000000000000S000G0000S0G00C0
000S00T00GG0000000000000000000
0000S0T00000000000000000SC0G00
G00T0G000000S00000000000H00000
0S000000000000000000T00G000000
0T0000000000000000000000000000
000T0000000000000000S0000GS000
000000000000G0000S00G0000000T0
000000S0SC00G00000000000000G00
00T0000000G000000000000000G000
00000000G00000000000000T00G000
G0000000000000T000G000000S0000
0000000000G000000000000S000SC0
0000S000000000000000G00000S000
0000000000G000S0000000G000T000
00000000000000S0T0000G00000000
000000S000000000000000T000000G
00000000000000G000000000S00000
0S0G00000T00000000000000000000
000000T00000000S00000000000000
