000000000G000S0S0M000000000000
00T000000000000000000000SS0000
000000000000000000G000T0S00000
00S0000000000G00000000G00000B0
000000S00000S00000M000000M0000
0000000S0G000000000000000T0000
00000T000000000000G00000000000
0000000000000000G0000000000000
0G0000T0000000000S000000000000
0T000000000G00G0B00B000S0000B0
G0000G00000000B000000000S00000
00000000000G000000000000000000
000000000000S0000000000G000000
0000T0000S000SM0000000G0000000
000000000000000000000000T00000
0000000T00S00000000000000S00G0
00000000000000G0G0000TS0000000
0000G00000000000000000G00000B0
0000000000000000000T000000GS00
G00G000000BS00B000000000S0000B
0000S000000000000000000T000000
000T000000G0000000000000000000
0T0000000000S000G0000000000000
0000000000000000S0000000000000
00S000S00T000000000G00G0000000
00000000S000000000S000M0000000
00000000SG000S0000000G00000B00
00000000000S000000000S0000T000
SG0000000G00000000000000000000
0000000000T0G0G000000000000000
