S00000000000000000000000000000
00Sg00000000000000000000000000
000000S00000000000t00S000M0000
t0000g0g00000000S0000000S00000
0g00t000S00000S000000000000000
0000000000000t0000000000000000
0000000000000000S00000S000000t
0000000000g0000000t00000g0SS00
000g00000000000t00000000000000
0000000000000t0000000000000000
0000000000gg00S00t000S00000000
0S0S000g000000000gM000t0000000
0000000g0000000St0g0000SB00000
0000000000S0g000000000S00000MM
0000000S00000t00000S0000000000
0000g00Sgt000000000000000000BS
00000000tS000g00S000M0000M0000
000000t000S00g0000g000000S0B00
0g00S000000000000g000000000000
0t00g0000000000000000000000000
00000t00000g0000000000000000g0
00000000t000000000000000000000
0000S00000g0000t0g0S00B0000000
0000000000S000000000000g000000
00000g000t000000000gS000000000
0g0000t00000000000000000000000
0000000Stg00000S00000000000M00
0S000000t0000000000S0000000000
0S0000000000000000000000000000
0000t000000000000000S000000000
