000000000000000000000000000000
00t00000000S000000000S0000M000
0000000S0000000000000t00000000
000g00000000000S000000t0000000
0tS00000S00M000000000000000000
g00000000g000000000B00000t0000
000000000000000000000000t00000
0tg000000g00000000000000000000
0000000000t0000000000000000000
g00t0000000000000000g000SS000B
00000St00000000000000000000000
0000t0000000000000S00000000000
g0S00S000000M000000M00000000t0
0000000000000000gg00000000t000
00000000000t0S0000000000000g00
0t0000g000g00S0000000000000000
0000000t0S0000000S000000000000
0000000000S000000000000000000g
000000000000000g0g000000000000
00t00S0000000000000000S0000000
g00000000000000000000t00000000
000S00S0000tg00000M000000M000M
0000g0000000gS00000S0000000000
000S0000000t000000000000000000
t000000000g000000S000000000000
t00000S000000S0000000000000000
t00000000000000000000000000000
0000t0000000000000000000000000
00000000000000000000000t000000
0t000000000000000000000000000S
