00S000S0000000GT0CG0000000C000
T00000G00000000000000000000000
0S00000T0000000000000S000000C0
00000000000000G00000000S000000
0T0000000000000000000000S0000G
000000000000000000TG0000000000
0000G0000S0G00000S000H00000C00
000G0T000000000SGS00000000000C
00S0000S0000C0000C00000000T000
0S00000000G0000000000000S00000
000000000000T000S000000000000S
0000GT0000000000000000S0000000
00TG00000000G00000000000000000
00G0000000000T0000000000000000
00T00000000000000S0000000S0000
0000T0G00000000000000000000000
000000000S0000G000000000000000
0000T0S0000000000000000000000G
00S0000000000000000T0000000G0G
00000000000000000000000T00G000
T0S000S000G0C00000000000000000
00T0000000000000S00000000000S0
00000000G00S0000000000000T0000
0SS0G0C00T0000CC0C000000000000
000G000000T00000000000000S0000
0000000SS0000000000000000C0000
0S00G000T0000000G00H000000S000
000000T0000S000000000000000000
0000000GT0000000000G0000S00000
000G000000000000G0T00H00000000
