0000000T000000000S000000000000
000000STSM00M000M0M0000000G000
00000000000G00G000S00000B000T0
0G00000000S00000000000G0BBS00T
000T0000000000000S000000000000
000000000000000000S0000000T000
00000000000000000T00000000000G
T000000000000000000000G0000000
0T000000000000000000000000000S
0000000000T00000S0000000G00000
0S0000000000000000G00000000000
T0000000S00000S0000000000G0000
000000000000S00000000GGTS00000
000000000GS00000G00S0000000000
00000000G0S0000000G0000T000000
T0000000S0000000000000S0G00000
000S00000000000000000000000000
00000S0S0000000000G00000000000
00000G00S00S00000000000G000M00
00000000S00S000M0000G000000000
00S0T00000S000000M000000000G00
0000000G00000TG0000000000000B0
000S0G000S0000G000000000000000
00000S0000T00000000000G000000S
0000G00G00000T0000S00000000000
000000GT00000000000000G0000000
00000000S00000S000000GG0000000
0G0000000000S00TS00M0000G00000
00000000000000T00000SS00000000
0T0G0000G0000S0000000B0B0000B0
