0G000000G000STS00000
S0000000000G0S000000
00000000000000000000
000000T000000000000S
000000GS0S0T00000000
000G0000000000000S00
0SGG0000000000000000
0000G0000G0SS0000000
0ST00G000000000S0000
T0000000S000S0000000
0000T0000000000SS000
S00GS0T0000000000000
0S000S000T000G00G000
0SS000G0000G00T00000
0T000000000000GS0000
0S000000000000000000
00000S0000G00000G000
000000000T0000000000
00G000G0000000000000
T000SS000000000G0000
