00S0T0000G00S0000000
00S000S0000000000000
000T00000000000SGS00
00000S0000000000000G
0T00S000000000GG0000
000T0000000000000S0S
S0000G00000G0000T000
0000T00S00G0S0G00000
000000000000G0000S00
00000000T000000G0000
T000S00S0000G0000000
S00SG000000T00000000
0G0000000T000000000S
0T00000000000000G000
000T00G0G0000000000S
G00T0SG0000000000000
00000000T0S00000G000
0S00000S0000000G0000
000G000T0G000S000000
000T0000000000000000
