00G000000000000000000000000000
0000ST0000S0000G00000000000000
00G0000S0S0000000000000000C0TC
00000000S000000T0000000S0000C0
00T0000S0000000000000000000000
00000000T0000000G0000S00000000
0G00GS0H0000000000TS0000000000
0G000000000000000G000000000000
S00T00000000000G00000000000000
0000000000000000000000000G0000
000000000G0000000000S0S0G00000
00G00000000000000000S0S0000C0T
00000000000000000000GT00000000
0000T0000000000000S0S000000000
0000000000S0000000000000000G00
00000000T000000000000000000000
0SGS00000C0000G0000000HT000000
G00T000000000000000000000000G0
00S000S00CC0000000000000000000
00000T00000000000000000000S000
000000000000000G00G00000000000
0G000G00T000000000000000000000
00000000000T00000000000000S000
0S0S000T0000000000000000C00000
00000000000G000000000000S000T0
0000000S0G00000000T0000S00000G
S000000G0000000000000000000000
000000000T0000G000000S00000000
000G00000000000000000000T00000
GTG0000000H00000S0000000000000
