000000T00000000000000000000000
0000S00000000000000000000G0G00
ST00S000000000000000000M000000
G0G00S00B00S0000000B0M00000M00
0000000000000000T00S0000000000
000000T00000000G00G000B0000000
G0G000000000000000S000S00BT000
000000S0S000000000000G00000000
0G0000000T0000000000000000GS00
00000000000000S0000S0000000000
0000S0T000000S000000000000M000
000T000000S00000G0000000000000
0000000000T00000SGS000G0B00000
0S0000S0G000000MM000G00000B000
0G0000000G0000000000000T000000
0000000000000T0000000000000S00
0T00G0000000000000G000000000BB
00S00T00000S000000G0M00G0000B0
G0000000000S000000000000000000
0000000000000G0000000000T0G000
000GG0000000BS000000T000S00000
0T0000000000G000000000000S0000
GGS0000S000000M000000000M00000
T00000000GS0000000000000000000
T000G0000000000000000000000000
00000000000SG000000000000T0S00
000000T0G000000000000G00000B00
000000000G0T0000S000S0000000MG
00T0000000000000000S0000000000
00000000000G00S00G000000000000
