0T0000000S0000000000
00000000000TG000S000
00000000G00S0000GS00
00000G00000S0S00GT00
0S00000000000000T00G
00000000S000T00000G0
0000G0000GS000000000
T0000000000000000G00
00S000000000T0S00000
0G00S0T000G00S000000
0S0T00G00S000000C000
S0SG0C0000T00G000000
0000000S000GT0000000
0000G000G00000S000S0
0000S00000TS000000C0
000T000S0000G00S000G
0S0000T0000000S00G00
000G0G0000S00000000T
00TG00G0000000000000
000S0000G00TS0000000
