00000S000S00000000000000000000
0000000000000000000000g0t00000
00000g000000S0000000000000tS00
00000000000000000000000St00000
0g000000g00000000t0000B00S0000
0000gt0000S0000000000000000g00
S0000000000000g00000000000SM00
000000t00Sgg000000000000000000
0000000S0S00000g0000t000000000
00000000S00S000000g00000000000
0S0000S00000000000g0000g0M0000
00000000000S000000000000000000
S00000t00000g00000000000000SM0
000t0g0000000000000000000000S0
0000000000t00000Sg00S000g00000
0000000000S0000000000000000000
00t00000000000000g00000S000Sg0
00000000g0000000000g000t000000
0t000000S000000000000000000000
0000t00000000gg000000000000000
0S000000t000000000000000000000
S00000S00000000000000000g00000
0g00000000000000g0B0B000000B0t
S000000000000000g00000t0000000
0000000000000000t000000000gg00
Sgt00S0M0M00M000M0000000000000
00000000000000g000000000000000
S000S00M0t00000M00000000000000
0000000000000gt000000000000000
000000S000000000000g0000000000
