S00SC00000G000T00000
00000S000000000G0000
SG0000000000000000T0
0S0000S0000000G00G00
000T000S000S000000C0
000T000000G0000G0000
00000TS00000000S00C0
G000T000000S00000000
T0000000000000000000
00000G00SG000000S0C0
00T0000000000000G00G
0000TG000G0000S00000
000S0G00S00GC0000000
000000000STS00000000
000G000T00G000000000
00G00T000000SS000000
0000S0T000S00G000000
000000GG0000000T0000
00000000S000000T0S00
00S000000000000TG000
