00T000000000S00000G0S000000000
000000000000000000T00G00G00000
000000000000000000S00000000000
000000T00000000000000000000000
0000000000SGG00000000000000T0H
000000GG000S0000S00000H000T000
000000000T00000000000000000S00
0SGS00000G000000000CH000000000
0G00000000S00000000G0000000000
00000000S0G000S00000C0000T0000
000000000000000000000000000000
0000000000000G00000000G0000000
000G00000000TS00000S00000GH000
00S000000T000000GS0C0000G00000
0000000S00G0000GH00000000000S0
00G00000S0000000000G0H00000T00
TS0000000S00000000000C00000000
00T00000000G000000000000000000
00G00000000000000000000G00T000
T000000000000000000G0000000S00
0SG0000000000SCT00000000000000
0TG0000000000000000000000G0000
000000S00G0T000000000S00000000
000000000S000T000000000000S000
000000000000T00G00000000000000
0000T0S0G000000000000000000000
0S00000000G00000000000000GH000
0000000000T00G0000000000000000
000000000000000T0000000000G000
SG0000S0T00C000000000000000000
