000T00G0G00000000H00000000000S
000G0000000S0S0000000000000000
G00000G000000S0S0T00000000H000
00000000000GG000S0000SC0H0000T
0000000G000000S000000000000000
00000S000000G0000000GHS0000000
G00TSS0CC0000000000000000C0000
00000G00000000T000000000000G00
00000000000000000S00SG000000T0
000000000000000SG0000000000000
00G00S00G00000000000H00000T000
0G0000000000S000G0H00000000000
000S00T000000000000000000000G0
0T0000000000000SG000000G00S000
000000T00000000GS0000G00000000
000000T0000S000000S00000000000
000000000S0000G0000G000000H000
0000000000000T0000000000000000
00000000S0000000S00T0000000C00
000G000T0000000000G00000000000
000000000000S000000000G000G00H
0S0000SG00C0T00000000000C00000
0000000SS000000000G000000000G0
S000000S00000G0000000G0000000H
000000000000000000G00S00T00000
00000G00000000000S0T000000S000
00000000000000000000000S000000
000GG000000000S000S0CH00000000
000000000S0000000000000G0T0S00
0G00G0000000H0S000000H00000000
