S00000000t000000g0000000000000
0000000000t0000000000000000gg0
000000000000000000000000t00000
0000000000S000000S0000000M0000
0000000000000S0000000000000000
t000000000gg000B00000000000000
0000000000000000S000St00000000
00000000t0g000000000000S000000
00Sg00000000g0000BS000B0t000B0
t0000000S00S000000000000M00000
00g00S0000g00000000000000B0000
0t0000000000000000000000000S00
t00g000000g0000000000000000000
0000000000000t00000000g00Sg000
St0g00000000g0000S00000BM00000
g0000g00BS000S00000M0000000000
00000000gg00000000B0t000000S00
00000St000000000000000000g0000
00000t000000S000S00000000000g0
0g000000000000000000000tg000S0
gg0000t0000000B000B000B0S00000
00S000g0000S0M0000000000000000
00000000000S000000000000000000
0000000g00000000t0000000000000
0t0000000000000000000000000000
000S00t0000000000000gS00000gM0
00000000000S0000g000000S000t00
000t0S00000g0S000000g000000000
gS0g0000000B00000000000BS00000
00000000t000000000000000000000
