00000S00000T00000000000G00S000
00000000000T000G00000000000000
0000T0000000000000000000000000
00S0G000S000000000000000000000
T0000000000000SG0000S0000C0000
T00000000000000000000000000000
000T000G000000000SG0H00H0S0000
00000G00T0000000000G0000000S00
S00000000000G00GTH000000000H00
000000G00000000000000000T00000
0G0000000000000000T00000000GH0
S0SG0C0000T000000000G00000000C
00000T0S0000000S000G000000CC00
000000000S0T000S00000000000C0G
0000S0000000000000T00000000000
0000T00SG000000000000000S00000
00000000000T000S0SC00000G0C0C0
000000T000000000S0000000000000
0000000000000000G0000000000000
0000G00T0000000000000000000000
00S000S00000T00000000000000000
000000G00000000T00000000000000
00000S0G0000000G00000000T00000
00G000000S00000000000T000G0000
000G0000000000G0000000000S0000
0000000000000G0000S0S00000T000
000000000T00000000000000000000
0T00000000000000S00000000000S0
0000000000000000000000G00GTS0H
000000S00000000S0G00000000000C
