00000T000000000000G00GS0000000
000T000000000000000GSG0000H000
0000000000000000S00000T0000000
0000000000000S00G000000000G000
00G000T00000G0000000000S0S0000
000000S0000G00S000000000000C00
0S0000TS0000000000000000G00000
GS0000000000000G0T00000000000S
GG0H00S000000S0000T0000000C000
0S0000T0000000G000000000000000
0000000S00000000000000000S00T0
0T00000GG000000H00000000000000
0000000000000000000000S0000S00
T000000000000S0000S0000C000000
S000S00C0000000000G0G00H000000
000G00000000000S0GS000H0000T00
G00000000T0000000000000000000G
000000S0000G00000G000000000S00
0000000000G000000S000000000S00
000000000000SG0T00000000000000
00000T000000000000G000000G0000
00000000000G00T00000S000S0G000
00000G00000G0000TS0000S0000000
00000000000000000G000G00000000
00S0000000T0000000SC0000000000
S0S0000C00000000000000000000T0
S0000000T000000000000000000000
00G000000T00000000G00000000000
000S0000000S000000000000000000
00000G0000S00S000000000T000000
