00000000S00000T00000G000000000
00000T00000G000000G00000000000
000000S0TS00000000000000G00000
00T0000SS000000000000000000G0C
000S0G000000000000000000S00000
000000000000S0G000000T00000000
0000000000000GS000000000000000
G0S0000000SC00GH000T0000000000
0G00G000000S000000H0000T00000S
000000S0000000000S0000T0000000
00000G0000000000S000000G000000
0000S00GG000S000CT000H00000000
0000T0G000G0000000000000000000
G000000S0000000S0T00000C000000
000S0TS000GC000000000000000000
00000T0000000G0000000G00H00000
0000000000T00G000000000000000S
00000000000S0000000G000000000G
000ST0000000000000000000000000
0000T00000000000000000000G0000
00S0S000GG0T000000000000000000
0000000000000000000000000G0000
0000000000000GG0H00000000S00S0
00G00000000000000000G0000S0T00
00000000SG0G000000000000000S00
0G0000000000S0000S0000000G0000
00T000G00000000000000S00000G00
000000000000000000000000G0000G
000000000G00000S000T0S00000000
00SS0C0000000000000000000G000T
