00000T00000G000000000000000000
000000TS00S0000000000000000000
0000000000T000000G000G00000000
00000000G0SS00G0000H0000000000
000S0T0000000S000G000000000000
0S0000GS0000000000000000000000
T0000S000000000S000000C000000G
00S00G00000000T0000000S000GH00
0T000000000000000G000000000000
G00000000G00T0000H0S000000000S
00000000000000000T000000000000
00000000000T000000G0G000000S00
T0000000000000G00000000S00G000
00000G00G00000H000S00000000000
0S0000000G00000S00000000T00000
0000T000000000G00000000000SS00
T000000000000000000000S0000000
G0G000S0000000S0000C000000000H
0000S00000000T0000000000000000
0G00G00S00000000T0000000000000
0000000000GT0G0000000000000000
0000000000000S000S000000G00000
0S000S00000000000C0000000G0T00
000000000000000S0G0000T0000000
00T00000S000000000000000000000
00G000000000G000000T0000000000
0GG00000000000T000HS000000S000
00000000000000000000000T000000
00000S000000000000000000000000
SG0000000G00000000H000S0000000
