00000000000000T0G0000000000000
S0000000000G000000000G00000000
T00S0G000000G0000000000000S000
G000000000000000000SG000S00000
00000000000000000000000G000000
000000000S0S00000000C000000000
000000000G0000000G000HS0000000
00000000T000000000G0S0S0000000
000000GT0S00000000000G00000000
TS0G0000000000S00000C000000000
0000S0000000S00000G00000000000
0000S00S00C000G0000000G0000000
000000000000000000000000000000
00G00000000000000000S0S0000C00
0T00000000G0000G0H000000000000
0G00T00000000000GH000000000000
0GT000000G0000000000000000000S
00G0000G00000T00000000000000S0
000000000000S00000S00T000G0000
00000S000T0GG0000S0000CH000000
S000000000G00000000000000G0000
0S00G00G000000S000000000000T00
000000000000000T0000GG00000000
00000000T00000000000000000000S
00000000000000000000000SS00000
0000G000000000000000S0T0000000
0000000T0G0000S0000000000000G0
00000T000000000G0000000000000G
0000000S00000S00C0000T0000G00G
000000S0000000T00000S0C0000000
