000S000000000000000T0000G00000
00S0G00000000000T00000000000G0
00G00000000000000T0SS000000000
000000000000000000000T00000S00
00G000000000G00000000000000000
00000000000000000S00000T000S00
0G0S000TS000000000000000000000
000T00000000000000000000000S00
0000000000S0000GT0000000000000
0000000000000000SG0GH000000000
TG0S0000000000000000S000000G00
00000000000S000000000G00S00000
00000G000000000T00000000000000
G000000G0HT00000000000S0S000C0
00000000000000000S000000000T00
0000000T00000000000000000G0000
0000S0000G000T0000000000000000
0000000000T0000000000000000000
0GT0000G00000000000H0000000000
00000S0000000000000000T0000G00
0000000000G000000000T000000000
S0000G0000000000000S0000000000
S000000000T0000000000000000000
G000T0000S000000000000000000S0
000000G00T00000000000000000000
0T00G00G0000000000000000000000
000000000000000000000000000000
00000000000000000G00000000T000
00000T00000G000000000000000000
00000S0T00000000G0000000000000
