00000000G00000G0T0000000000S00
00S000S0000G0G00000000000C0000
S0000000S0000000000000G0000000
0000000000T0000000000S0000S000
000G00000000T00000000000G00000
000000000000000000000000000000
000000000000000S000000000000TG
0SS0G000000000000C00C000000000
000000000G00T000000G0000000000
0S0TS0000000000C00000000000000
000S00ST0000C000000000C0000000
000000000S0G0S000000C000000000
0S00G0000000000000000S000000C0
000000000000G000ST00S00CG00000
00000T00000S00S000000000000000
00000000G00T000S00000G000H000H
000000000000000000000000000000
000G000000G0000000000SS00T0C00
G0000T0000000000000000S000G000
000000000G00G0000000S000H00000
SG000T00000G00000000000000S000
00000000000ST000S000G0C0000C00
000000000S00T00000G00000000000
0S0G00S0G0T00000000000000000C0
00000000000000000S000000000000
0000TG000000000000000000000000
0000000000S0SC000000000000T000
0000000S0000S000000T0000000000
00GT0000G000000S00000000000000
000G00G0000T0000000000000000H0
