00S00t00000000000g000000000000
000000000000000St0000000000000
00000S00t0S0g000000M0000000g00
00000S0g00000000000000g00t0000
000t00000000000000S00000000S00
00t0000000g0g00B00B0000000B00B
0S00000000g0tg00000000000SB000
00000S00000000000tg00000000000
0000000000g000t000000000000000
g0S0000000g000000000000S000000
0000000S0S0000000000000t000000
00000000000000000t000000000000
0S0t00000000000000g0000SM00000
00000000000000S0S0M000t000gg00
000000t000000000S00000000000g0
00000000000000000t00000000000S
0t00gg000000000000000000000000
000S000000t0000S00000000000M00
000000S000g0000000g000t0B00000
t00000S0000000000000g0000g0B00
00000000000000t000000000g0g000
0g000gS00S000000M000000000tM00
000000S000000t0g000S00M0M000M0
000000000000000000000000000S00
0S0gg00000000000S00B000t000000
0g0000t00000g00000000000000000
00000000t00000S000000000000000
0000t000000000000g000000000000
00000t0000000g00SS0g00000000B0
000000000gS00000S000000000000t
