0000SS0000000G00000000G0000000
0000T0000S0G0000S0000000000000
0000T000000000000000000000000G
00S0G0000G0000000000000000000T
0S00000T0000000000000SC0000G00
000T000000SS0000000000000000C0
00000G00000000000000T00000000S
G00000000000T00000000000000000
00000000000TG0000G000000000000
S00000T00000000S00C00000000000
000000G0000T000000000000S00000
0000G0000000000T0S00000000G000
0000000000000000000000000GG0HH
S00000T0000G000000000G00000000
0000000000T000000000000S0G0000
000000T0S000G000000000G0000000
0S000000000000G000000000000000
000000000000000000000000000000
0T00000S0S0000000G00000000C00C
0000000000SS00000G000000GTH00H
S000000000000000G0000000T0SC00
00000S000S000000000G00000T0000
0000T00000000000S0000000000000
0000000000000000T0000000000000
000000S00G00000T000000000S0000
0G000G00000000000000000000000T
000000000000000S00000000S00000
000G000T0G00000H000H000000000S
0000G0S000000000S0000000000000
0000S0000000G0000000000G0T0000
