000000000000000000000T00000GS0
00000000T000S00G0S000000000000
00000000000S00G0000T000G0000H0
00T00000S0G0000000000G0000000S
00000T00000G00000000000000G0S0
000000S00G00000T000000000G0000
00000000T000000000000000000000
0G0000T0000G00S00000000H000S00
00G0000GH000T00000000S0H00H000
0000000000000T0000000000000000
0G0GSS000000000T000H00000H0000
0S0SCG0000000000G0000000000000
00TG000000000000000S0000000000
00000000000000000G00S00T000000
0000000000T0000000SG000G000000
0000S0000T000000GG000000000000
S0G0G000T0000H00000000000000H0
00S00000G0G0000000000000000000
00S0T0000000000SG00000000C0000
000000G000000T0G00H000000000SS
0S0000000G00GT0000000000H0000H
00000000000000000GS00000000000
0G00000S0000T00000000000G00000
0000000S0000000000000G000T00G0
0000T000000000000S000000000000
000G00T00000000000000000000000
0000000G0000T0000000000000000S
00000000000000000000T00000000S
000000G00G0H000000000S00000000
0000000000000000000G00000S0G00
