00G00000000000000T00
000S00S000T000000000
000G000000000S00T000
00000G00000000000000
000000000000000GT000
T00S0000S0000C000000
00S00T0000G000SCG000
000SS00000G00C000000
0000T0000S000000SG00
00S0S000000CG0T00000
0S00T00000000000000S
00000G000STS0000G000
STG0S0G0000000000000
0G00000TSG000000000S
00S0G000T000000000S0
T0000000000000S00000
00000S0000000000000S
0000S000T0000000S000
00G0000000G000000000
0000000S000000SG0000
