ST0000000000000G0G00
00S0S0000G00000G0000
00G0000S000000000000
00T00GG000S000000000
0000000000SST00G0000
G000000000G000000000
0GG0000000TS00000000
0G000000001000SS0G00
000000000T00S0000000
T000G0G000000S000000
000G00000000000TS000
00SSG000000000T00000
0000T000000000000000
000T00S0G00000000000
0T00000000000G000000
S0000000000000000000
0000000G000000G00000
0000T00S000000000000
0000GT00000000000000
000T0000G00G00000S00
