T000000S0000S0000000
000000T000S0000G0000
T0000000S0S0000G0C00
0000000SG00000000000
000G0000GST0S0000000
00000S0ST00000000000
00SS00T0000C00000000
0G0000000S0G00000000
000T0000000S00S0C000
0000000G000000T00000
SGTSC000000000000000
000T0000000000000000
00T00000000000000000
000000T000G000000000
GGT000000000S0000000
S000000000S000000000
0S0000000S0000G00000
00000000000000000S00
00G0000S0G00000S0000
00000G000000SG000000
