000S0T000G0000G00000
0000000S000GG0ST0C00
0T00000000S000G0000G
00GTG00000000000S000
0000000T000000SS0000
S000000000G0000T000G
000T00G00G000000000S
0G0000S00T0000000S00
00000000000000000S00
00000TG0000000000000
0000TS0000000S000000
00000G000000T0000000
0000000G0000000T0000
0S00T0S000000C0G0000
000000000S0G0S0C0G00
00000G00000000G0T00S
G0S00000000000000000
000000G00ST000000000
00S000000000ST000000
000G0000000000000000
