0000000000000G0000000000000000
000000000000000T0G000000000000
G0S000000T00SG0H000000H0C00000
000000000000T00000000000000000
00000000000000T000000000SG0000
000G00000000S0000000G00H000000
0000000000000000G000000000T0S0
000000000G0T0000000000000G0000
0000T000000000000000G000G00000
0000000S0S0T00000000000000000C
00T00000G00000000000000S000000
00G000ST000000G0000000000000H0
00G00000000000TGH000000H000000
000TS000G000000000000000000000
0000G000000G000S000H000H000000
00000G0S00000000TG0S0000000000
000000000000G00000000000G00000
G000000T00000000S0000000000000
0G000000000000000000T00S000000
0000S0T0000000000000000S000000
000T00000000000000S0000000S000
0G00000S00T000G000S00000C0000C
000000000000000000000000000000
0000000S000000TG0000000000000S
000000S00T000000G0000000000S00
000000T00S0000000000000000000G
00000G0T000G000000000000H00000
S000000S000000000000000GGT0000
0000000T0S0000000000G00G000000
000000000000000000000000000000
