000S00000000G00G0000T000000000
000000000T000G0000000000000000
0000000S000000000000000T000000
000000000G000000S000G00000T000
000S000G00000000S00T000G0000C0
0000000T00000000000000G0000G00
0000000000000000000000000T000S
0000G0S00000000G000000T00S0000
00S00000000000000000000000000S
00000000000G000000000G00T0S000
00G00T00S000000000GH000000S000
S0G0000000000000000T0000000000
00T0S0000000S0C000000000000000
0000SS0000T000000C000000000000
000000000000000000000000000000
000S00T00000000S0G000000000000
00000S00S0000000000C0000000T00
0000000000000000G0000G000000H0
000000S0000GG00000T0000H000000
00000000T00000000000000S000000
00S00T000S000C0000000000000000
000000000S0000T0000G0000000000
00000000000S00000000S000000000
00000000G0G0T00000000000000000
00S00000000G000000000000T00000
0000TG00000GH00000000000000000
00S0000000G00000000T0000000000
00000T00000G0000000000G0000000
0S00G0000S00000T000C0000000000
TS00S0000000C00000000000000000
