000000000000000000G00000000000
0000000G00T000S000S0C000000000
0000S00000000000000000G0G00000
0000S00G0000000000000000000000
00000S0000000SG00T000000000000
0G000000000000000000000T0S00S0
T000000000000000000000000S0S00
GT00000000000000000000S0000000
0000000000000000ST0000000S0000
000000000000000000T0G00000S000
T0000000000S0000G000000000G000
000000S000000000000T0000000000
0000G00000000000000S0000000ST0
0000T0000000000G00000SG00000H0
0000000000000T00G0000000S0000G
0000000000000G0000000000000000
0S00T00000000000G00000000000G0
00T000G00000000000000000000000
000G0000T00000000000G0S0H00000
0000000G00T000000S000000000000
0000G0SS0000000000CC0C00000000
000S00G00T0000S00000000G0C0000
T0000000000000000S000000000000
000000000G00000000000000000000
00000000G00000000000G000000000
00T0000000000000000S0000000000
00G000T00000G00000000000H00000
00S00T00G000000000000G00000000
0T000000000000000000000000S000
00000000T000000000000000000000
