0g000000t0000000g0000000000000
00000000000g00000S000000000000
0t00000g0000000000000000000000
0t00S0000000000000000000000000
00g000t00000000000000000000000
0t0000000000g00000S00g0000S000
00S000g000t00g0000000000000000
S0000g00000t000000000000000000
00000000000000000000000g0S0S00
00000S000t00000000g0000000g000
t00000000000000000000000000000
000t000000S0g00000000000g00000
00g000000000000S000000000St000
00000g00000000g00t000000B0000S
0gt000SS0000000000000M00000000
0000000000gS00000g0000000t0000
0000000S00g0000000S00000000000
00t0000S0000g0000000000S000g00
000g00S0t000g00000000000000000
0t0000000S0000000000g000000000
t0000000g00g000000000000000000
gt000000000000000g000000000B00
00g000000000000t0000000000g0B0
0S0000S00t00000g00g00000000000
00000t000000000000000000000000
000S000t00000000S0000000000000
000gg0000000000000000000000000
000t0g00000S00000g0000000B0000
00SS00gM0000000000000000000g0M
000S0000000000g000000000000000
