0000T0S00S000G000000
T00000G000S000000G00
0T00SGG000S000000000
S0G0T00000S000000000
00000ST0000000000S00
00S000000G000S000000
0G00000000G0T0000000
00G000000000000S0G00
000000000000000T0000
00000000T000G0000000
G000S000000000000000
00000000T0000G000000
000TG000G0000S0S0000
0G00S00T000000000000
00000000000T00G0000S
00000S00000000G00000
00GS0000000000S000T0
000GS00S0000G0000000
00000T000G0S0000G000
00G0T00000000000G000
