0000000T00000000000000000000G0
G000S00000000T000G0S0000000000
G0000000000S0000000000S000G0T0
00S00G000000T000000000G00S00H0
000000000000S00S00000C00000000
000000G000000000000000G0000000
00000S000TS0000000000000000000
000000000000000000000000S0S000
0GT0000000000000000000000G0000
000G0G0S00TH000000S0000000C000
000000000000G000T0000000000000
000000000000G0000G000000000000
0S00000000T0000000000000000000
00G000000000000000T000000S0000
00000000000000000T000000000000
00G00G0S0000H00000000000000000
0000S00G00S00C00000000000000C0
000000T0000000S0G0000000000000
000000000000S0000T000000000000
G0000GS0000T000000000S00000000
00000000S000000000000T00S00000
00G00000000000000S00T000000000
00000000S0S0000T0000000C000G00
0000000T000000000000000G000000
000000000G00000000G00000000000
T0000000G000000000S000000S0000
0T000000000S00000000G000000000
000000000000000000000000000000
00000TG00000G0000000000000H000
00000S00000000000G000000G00000
