00000G000000000T00000000000000
0000GG00000000S000T000000000H0
0ST0S00000000G0000000G00000000
G000000000TS0G0S000000000000C0
00000SG0000S0C0000000000000000
T0G0000000000G0000000H00000000
0T0000000G0000G000000000000000
00G0000S0000T00000000000000000
0G000S00T00S0000000000C00000G0
0SG00000T00G000000000000000000
0000000G000000000S000T00000000
00000000000000S0000TS00G000000
00000000000T00000000000S00S00G
000S0000000S0G00000000T00C0000
0000T0S000000S0000000000000G00
000000SG000T000000S00000000000
0000000T00000000G00000000G0000
000000000000TG00G0H00000000000
0000000G000T0G00H0000000000000
000000000000S000000G0G00000000
00G0G0H00S0000000000000000T000
0T000000000000000S0000000000S0
000000G0G0000000000000H0000000
00000000000000S0000000T0000000
000S0S000TCG000000000000000000
00000000G000G00000000000000000
000000000000000000000000000000
0000000000000000G0G00000000S00
0000000000S00000000T00000S000C
0G00000000000000000S0000000000
