0S000000000S0C000T000000000000
0S00000000000GS00000000T00000C
00000000000T00G0G00S0000000H00
0000G000000000000000T000000000
00000000000G0G000000T0S0S00000
00000000000000T0000000G0000000
T000G00000000S00GS000000000000
000000G0000G00000000HS0000000T
00GT00000S0G00000000000H000H00
00000G00T000000000000000000000
00S0000000S000000000G0C00G000T
000000000G0000S000T000000000S0
T0G000000000000000000000000000
0T0000S00000GS0000000000000G00
S0000000000000000T0G0000000000
000S000S0000G00000000000000000
00000S000S0000000G0T0000000000
000G000000SG00000000S00T00C000
00GS0T0000001000G0000000000000
0S000000S000000T00000000000000
000T0000G0000SG0000000S0000000
0ST0000000S000C0000000000C00GC
00G0000TG0SS0000C00C0000000H0H
00T00000000G000000000S00000000
000000000000T00000S0000000000S
00TG0000000000000000000000000G
00000G000GS000T000S000000000H0
00000000000G0000000000000T0000
GG0000000T0000000000H000000000
00S000000000S00000T00000000000
