000000000000000000000000G00000
000000000S00000000000000000000
00S00000000000000000000T0SGC00
0000000G00000T0000000S00000000
0000000000000000000T000000000S
000T000000000000000000G0000000
0000000GS000000T0G000000000000
000000S00S00GG00000H00T0000000
000G0GT00000000000000000000H00
000000T000000000G00S0S00G00000
G0000TS000G0000000000000000000
000000000000000000S0000ST00000
T00000000000000000000000000000
000G0G00000T00000SHS00H000C000
S0S000000000000000000000000G00
0000000000T00S0S0000000000G000
0000000GT0000000000000000S0000
000000S000000000T00GS000000G00
GG0S00000S00000H0000000CC0000H
000000000000000000GS000000SG00
0S00000T0000000SC000000000000G
00S0T0000000000000000G0S000000
00000000000000000000GS00000T00
000000S00000S000000000000T0000
000000G00T0000000S0000000S0000
00000T000000000000000000S00000
000000G00000000000000000000000
00G000000000T00000000000000000
0S000T000000000000000000G00000
00S000000000S000000000T0000000
