000000T00000000S0000000000S000
G000G00000000000H0HH00H00000S0
0000000000G000G000000000000TH0
000000S00000T0G000000000G00000
GS0000000G00000000000H00000000
00000000S00000S0000000000000G0
0000000G0000000000T00000000000
ST000000000000S000000000C00000
000S0000T00000000000S0GG0000C0
00T0S00000G0000000000G00000000
000000000000000000000000T000G0
00000000000000S0T000000G000000
T00G000000000G00000H0S00S00000
0000000000T0S00000000000000000
00000S0G0000000000G0000T000000
000000000GT00G0000S00000000000
00000000000S000G0000S000000000
0000000000000000000000000T0000
T000000000000000000000000G0000
0000000000000000000S0G0000000T
0000000S0000000000000000000T00
0000000000000G0G00000000000000
00G00S00000000000000000000S0T0
0S000T0S0G0000C00000C000000000
00000000000T000000S00000000000
000SSTCG0000000000000000000000
0G0000000000000000000000000000
000G0SGH0S0000H000000000000000
0000GT00000000S0G00SH0C0000000
000000000G0000000000000T000000
