00000G0T00000S0000000000000G00
0000000000000000000GG000000000
000000S0000000T000000000000000
0S0000000000000000S00000000000
0GTS0GS000000C000000000000000H
000000000GG0T0000H000000000000
00000000000T000000S0000000000G
0000000G000000T0000S0000000000
00000000ST0000G000000000S00000
000000000000T0000000G0G00000S0
S0000000000000GSC0000000000000
00G0000T000000S0S0000000000000
00G0000000000T0000000000000000
000000000000000000000000000000
0G0SG00000000T0000000SC0000000
0000000T0000000000000000000000
00T0S0000S0G00C000000000000000
T0000G0000000000000000S0000000
00000000STG00000000000S0000000
000000000TG000G00000S000000000
0T000000000G000000000S0S0000C0
00000000000000000000T0000S0000
000000G00000GT000000S000000000
00T00000000000000000000000000G
00000S00000000000000T00000000S
0000000S00000000G00000000000G0
00000000000000000000000000T0G0
00GG0000S000000000S00000CT0000
T00000000G000000000000G0000000
0000000000000G00G0000000H00000
