000S0000000T00000000
000000TG0G0000000000
000000S00000000000G0
0000SG00S00000000000
00000GG0000000S00000
000S000GG00000000000
0G00000T000000000000
0G0S0GS000C00000000T
S0T000000G0S00000000
0000000TG0000000G000
0GT00000000000000000
000G0S00000000000000
00000GG00TS00000S000
T0G0S0G0000000000000
00000G000000G0000000
0000000GG00000000000
000ST000S00000C00000
000S00S00T0000CG0000
00T00000000000000000
000000000000000000T0
