S00000000000000t000g00000g000S
0000gtg00000000B00000000000000
0000S0000000t0g0000000000S0000
0tS000g00000000000000000000000
000000000S0S000000M0000000g000
000000S0000000000000000000g000
0000000S0S00M00M00000000000000
0000g00t000000000g000000000000
000000S00000S00000000000t00000
00000000000t0000000000g0000000
000000g0g0B00000000B0t00B00000
000000g000000000g00000B0000t00
000000St00000S0000g0000000g000
0t0000000000000g00000000S00000
000000000000g00S00000000000000
t000000000S000S000000000000000
0000000000000000S0000000t00S00
t0000000000000g0000000000000S0
000g0000000000t00000000S0000S0
000000000000000000S00000t000S0
0000St0S00000000000MM000000000
00t00000000S000000000000000000
000tS00000000SM0000000000M0000
00000000000t000S000000000000Sg
000t00000S0000000000000g000000
00000S000000000000000000000t00
SS000000000000000000000000M0t0
00000000000000g000000000000000
0000t0S00000000000000000000000
t00S00000000000000000000000000
