0000000S000G000000T0000S0000C0
0S0GG0000000000SHT000000000000
000T000000000S0000000000000000
0000000000S0000000000000G00000
000000GT00G00000000H0000000000
00000000T000S00000000000000000
00000TS0S0000000000000000C0000
T0000000000000000S00G000000000
000T000000S0000000000000S00000
00000000000000000000000S0T0000
0S000G0000S000000G000000000000
000000G0000000GST00000H0000000
0G0000G00T00000000H000000000S0
00S00T0000000G0000000000000000
000000000000000000000000000000
0000000GSGTH000000S00000000000
000S000000G0TS00000000000C0G00
0S0000000S000000000000000000C0
00T00000S00000000G000000000000
0000S00000000000000000000G00G0
0000000T00G0000000000000000000
00000000000000000000S0GST0G000
000000000000G0000S000000000000
0GS000000000000000000000000000
0S000000G00S00000000T000000C00
00000S000T0S0000G0000000000000
00000000000000000000000T000000
00000000G00G00000000S00T00000H
000000000000000S00000000000000
0000G00T0000000000000000000000
