0000000000000S0G0SG0T000000000
T000000000S00S0000C00000000000
000000000000G0S00000S0G0000000
000GS0G000H000000T0000S0000000
0000000000000000000000G00S000T
TG0000000S000000000G00S00C000H
00T00000GG00000000000000000000
0G0000000000000000ST0000G00000
SG000000G000H00000000000000000
00000000G000000G00000TH0000000
0000000000000000G0TG0SH0000000
0000000G000SS0000C000000000000
0000G000000000000000000000T000
000S000000T0000000000000000000
0T0000000000000000000000000000
T00000000000000000000000000000
000STG00000000S000000000000000
00S0000000000000G0T000000000S0
000000S0000000000000000000000S
000000000TG0000000000000000000
00000000000T00000000G000000000
000000G00000S000000000T0000000
000S000000G00T0000000000000000
0T00000000000000000000000000S0
0000000000S0000000000000000000
00000G000S000000000S0000000G00
00S00S00000G00000T000000000000
00000000000000000G00G0S0000S00
00SG000000000000S0000000000000
000S0S0000000000GTCGH000000000
