000T00000G0000G0000S000S000000
G00000000S00G000S0000C00000000
00000000000G00000T000000000000
0000S0000G000000000000000000S0
000000S0T0000S0000000000000000
00000G000000000000000000G00000
00G0T0000000000000000S0S00G0C0
0000000000000G0000G0SS000T000C
0000000G000000000000000000000G
00000000G00000000000S000T00000
000000T00000000000000000000000
00000000000000000000000000T000
0000S0000T000S0C00G00000000000
0000SG0000000S0000000000000000
0S0T00000000000000000000000000
0T00000000000000000S0000000000
00000000000T000000S000G0000S00
00000000000000000G0000000T0000
00GS00000000000000000000T00000
T00000000S000GG000000000000000
00000000000T00G000S00000000000
0000000000GG0000000000000000H0
000000T00000000S00000000000S00
000000000000000000000000000000
SS0000000000C00000000000000000
000000000S000G000000000000000G
0000G000000000ST00000000000000
000000000S0000000000000000000S
0000000G0S00000000000000000000
000000000GG000000000H000000000
