0000000000T00G0000G000S00S0CH0
0000G0GH00000000S000000000S000
000000000000T0000G000000000000
00000000T000000000000000000000
T000000000000000000000S000S000
000000000000000S0000000000TS0C
0G0G00000H00S00000000000000000
000000T00000G000S0000000000000
000000000S00000S0000C000000000
00000TS00000000000000000G0S000
0000000000000000T00000S000000S
G00G0000H000000000000000000000
00T000000000000000000000000000
0000G0000000000S0000SC00000000
000000000000000000000G00000000
000000000T00000000000000000000
T000S0G00000000G000H0000000000
000000000000S000000000S0C00T00
SG0000G00000000000000T00000000
0000000000000000000000G00G0000
00000000000G00000000G000000000
T0000000000G0000000000000000S0
0S000000000G000S0000T000000000
0000000SS0T00000C0G00000000000
0000000S00000G00000T000000G000
0000000000000000TSS0C000000000
0000000000000T00000000000G0000
0G0000G000S0000000000000000000
00000G0T000000000000G0000000H0
00000000000G0T00000000S0000000
