T000000000000G0G0000
G0000000000000000T00
00T00000000GG0000000
0000000000000000S0G0
0S000000G00G00000T00
S000000T0000000S0000
0T00000000S0S0G00000
0000000GG00000000000
0000000G000S000000G0
GG00000SST000000000C
S000SG0G000000000000
00000000T00000S00000
T00000000000000S000S
S000T00S0000000000G0
0S0000T0000000000000
00G0000000G0SS0T0000
00000GT0000000S0S000
00000000T0000S00000G
00000000000T00000000
0T000000000000S00G0G
