0000000000000000GS00000000T000
00S00G000000000T00000000000000
0000G0S000G00S000000000000000T
0S0000T000000000G00G0H00000000
0000000000T00S00000S00C0000000
000000S00000SG0000000000000000
00000T000S00000000000000000000
00S00000S000000000000000C000G0
000000000000000S00000000000000
00000000000S000000000000G000S0
000000G000G00000000H0000000000
0G0000G0H0S0000000000000000000
000000ST0000000S00C00000000000
0T0000000000000000000000000000
00000000S000T00000000000000000
000T00000G00000000000000000000
0G0S00000000000000000000GH0S00
000000S00000000S000000G0T00000
000G0000G000000000000000000000
00G000000T000000S00000G0000000
00G000S00000SC0G0H000000000000
000000000T00S00S00000000000000
000G000000000000GS000000000S0C
00000000S0S000G00000000C000000
0000000T0000000000000000000000
00G00000000000000S00000000000G
TS000000000000000000000000G000
S0000G000000000000000000000000
00000T00000000S000000000000000
000GT0000000000S0000000000S000
