000000Sg00g000B0000000B000000t
00g000000000000000000000000S00
g000000S0t0000000000g000B00SM0
00000t00000000000000S0S00000g0
g00000000S00t00gBS00000M000B00
0t00g00000000000000000S0000000
0000000000000S0000S00000000MM0
000000gS00S00000000000000g0000
00000000000000000g0000000000S0
00S00000000000S0000000000Mt00M
00t00g0000000000000g0000000000
0000S0000000000000000000000000
0SS0000000000000000t0000000000
00t00S00000g0000000000000S0000
000000000t000000000000000000SS
00000S0S0t0000000000000M000000
00000t0000S0000000000000000000
00000t000g00000000000000S0S0g0
000000000000000t00000000000000
00000000S0Sgg00B000000B0000M0t
0t000S00S00M00000M0000MM000000
00t0S0000000000000000000000000
0000000000000000000000000000S0
000g000000000000000000000t0000
000St0000000000000000000000000
0t000000000S00SM0g00M000000000
g00000000S000000S00000t0g000B0
00t000000000000000000000000000
000t0000000000000000000g000000
S0g00g00000S000t000B00M0000000
