00G00000S0000000000000S0000000
T000S0G00000G00000000000000000
T000000000000000000GS00S000000
000T00000S0SG00000000000C00000
0S00S000000000000000000T00G000
000S000000000T000000S0000000C0
0000G00000000T0000G0000000000S
00S0000S00G00000000000T0000000
000000000000000000GT0000S00000
0T0000000000000000000000000000
0000000000000000T0000000000S00
0000S000000000G0000G0000000S00
S0SC000000G000000000T000000000
T00000000000000000000000000GG0
00000000000000000000T0000000G0
00G0G0T0000H000000000000000000
0000000000000000000S000S000000
000000000T000000000000S0000000
00G00T0000000000S00000000G0000
0000000S0000000000000000000G0S
0G000000000000S000000000000000
0000G00S0T00000000G00000H000S0
G0000000S0000000G00000S000000T
0000G0000T00000000000000000000
0000T00000G0000000000000S00000
0000000000000000G0S00000000000
000000000000G000S0000000G000S0
G000S000T0000000000000S0000000
0000000G0000000000000000000GT0
0000000G00000000T0G0S000H00000
