0GS00GT000000000S000
G0S0000000000000000T
000000000000000T00G0
S000G00S00000T0000G0
000000000S00G0T0000G
S0T00G0000000000000S
00000000G000T0000000
00000000000000000000
00S00T0000000S000C00
00000000000SS0000000
0T0S0000000000000000
0G0S0T0S00CG00000000
00000000000000000000
000S00S0000TC0000000
0000T0000S00000S0000
000T000000G000S00000
000000T00000G0000G00
000000T00000000GG000
0G0G00STS00000000000
00S000S00G000C000000
