0000000000S0S0000000G000000000
00S0000000000000T00000S00G0000
000000ST0G000000S0000000000C00
S00000000000000000000000000000
000000S00000G000T00S000000C000
S0SG00G000C00000000T00000H0000
00T000000000000000S0G000000000
000S00000000T00000000000000000
00000000000G0000000G0000000H00
00000000000000000000ST000S0000
000000ST0000000G000G0000000000
0S000T000000000G00S00000000000
0G00000000000T0000000000000000
00T00000000000000000000G0S0000
00T000000000000000000000000000
0000S00000000G000000000000S000
00000000000000S0000000S000000C
00S00000000000000G000000000000
00T0000000000000000S0000000000
00T0000000G0000000000000G0H000
000T00000000000000000S00000000
000G0T000000000000000000000000
0T000S0000S0000000000C00000000
00000G000T00000000000S00000000
0000000000000G00000000G0T00000
T000000000000000000000000000S0
0000000000TG000000000000000000
0000000000T0000000000000000S00
ST000G000S00000000C00000000000
G00S000SG00000000000000H000000
