G00000000000000000000G0000S0T0
000000000000000G000G0000TS0000
0000G000000000T000000000G000S0
0000TS00000S000000000000000000
00000000000000000000000G00G000
000000TGSG00000000000000000000
G0000000000000000000G000T00000
0000T00S0000000000000000000000
00S00S0000000M0M00000000GM0000
000000T00G00000000000000S00000
0000000000000000000000S0000TS0
0T000000000G00000000000000G000
000000000T0000G0000000000G0000
00000S000T00000000000000G00000
T00000000000000000000G00SSM000
0S00000000T0000000000000000000
00000000S000000000T000000S0000
0000000000T0000000000SS0000000
0000000000T0000000G000000000G0
SG0000T0000G00S000000000000000
00000G00000000000000000000G000
00000G000T00000000S00000000000
000000000000G00000000T00G00000
0G0TS0000G0000000000B00B00000B
T00000000000G00000000000000000
00000G0000G000B00BB000S0000000
0000000000T000G000000000000000
000G00000000G00000000B00000000
000000T000G0G00000000000000B00
00000G00000000000ST00000000000
