00S0000T0000000000000000000000
000S0000000000S00000G000000000
0000G00T0000G000S00000S0000M00
00000G0000000000S0S00MG0000M00
T000000000S0000000000000000000
000G000SG00000000000T00000000S
GS0000SG0T000000BM0000000B0000
000000000000000000G00G0T000000
T0000S000G000S00000M00M0000000
T0000000000000000000000000S000
00S0000G00T00000000S0G00B00000
000000G0000000G0S000T000000000
0000000000000G0000000000000000
T0000S000S00000000M0M00000M000
T00000000SG0000000000000000000
000S000S00000000M0000000000000
0000000000000000T00000G00G0000
SS00000000000000000000000M0000
0000T00S0G000S000000000000000M
0000000000000000000000000G00TG
000000000000S00000S000M000G000
0000T000000000000000000S000000
0000000000000000G00000SS000000
0000000S000T00000000G00000000G
000000000000G000T0000000000000
000000000000G00T000000000000GS
00S0000000000000000S0000000000
000T00000000000000S0000000SG00
0000S0G00S00000000000000000G00
0000000000T000000000G000S00000
